[TILESET]
CaveSheet

[NPCS]
Bat 24 298 239
Bat 25 377 316
Bat 24 508 331
Bat 24 412 391
Bat 25 1562 1593
Bat 24 1445 1242
Bat 24 1743 1206
Eye 24 657 609
Eye 25 262 917
RollingThing 24 1815 121
RollingThing 25 271  541
RollingThing 24 520 707

[WARPS]
388 1808 64 16 Mountain01 792 1576
994 816 64 16 Mountain01 1552 1580

[TERRAIN]
0 0 0 0 0 0 0 0 0 0 0 0 0 0 0 0 0 0 0 0 0 0 0 0 0 0 0 0 0 0 0 0 0 0 0 0 0 0 0 0 0 0 0 0 0 0 0 0 0 0 0 0 0 0 0 0 0 0 0 0 
0 0 0 0 0 0 0 0 0 0 0 0 0 0 0 0 0 0 0 0 0 0 0 0 0 0 0 0 0 0 0 0 0 0 0 0 0 0 0 0 0 0 0 0 0 0 0 0 0 0 0 0 0 0 0 0 0 0 0 0 
0 0 0 0 0 0 0 0 0 0 0 0 0 0 0 0 0 0 0 0 0 0 0 0 0 0 0 0 0 0 0 0 0 0 0 0 0 0 0 0 0 0 0 0 0 0 0 0 0 0 0 0 0 0 8 4 9 0 0 0 
0 0 0 0 0 0 0 0 0 0 0 0 0 0 0 0 0 0 8 9 0 0 0 0 0 0 0 0 0 0 0 0 0 0 0 8 4 4 9 0 0 0 0 0 0 0 0 0 0 0 0 0 0 8 12 1 7 0 0 0 
0 0 0 0 0 0 0 0 0 0 0 0 0 0 0 0 0 0 5 7 0 0 0 0 8 4 4 9 0 0 0 0 0 8 4 12 1 1 13 9 0 0 0 0 0 8 4 9 0 0 8 4 4 12 14 6 10 0 0 0 
0 0 0 0 0 0 0 0 8 4 9 0 0 0 0 0 0 0 5 7 0 0 0 0 5 2 1 13 4 4 4 4 4 12 1 2 2 2 1 13 9 0 0 0 0 5 1 13 4 4 12 1 2 14 10 0 0 0 0 0 
0 0 0 0 0 0 0 8 12 1 13 9 0 0 0 0 0 0 5 13 9 0 0 8 12 2 2 2 1 1 1 2 2 2 2 2 1 2 2 1 7 0 0 0 0 11 6 15 1 1 1 1 1 7 0 0 0 0 0 0 
0 0 0 0 0 0 8 12 2 2 1 7 0 0 0 0 0 0 11 15 7 0 0 5 1 2 1 1 1 1 14 6 15 14 6 6 15 1 2 1 7 0 0 0 0 0 0 5 1 2 2 2 1 7 0 0 0 0 0 0 
0 0 0 0 0 0 5 1 2 2 1 13 4 4 4 4 4 9 0 11 10 0 0 5 1 2 2 2 1 14 10 0 11 10 0 0 5 1 2 1 13 9 0 0 0 0 0 5 1 2 1 2 1 13 9 0 0 0 0 0 
0 0 0 0 0 0 11 6 15 1 1 1 1 2 2 2 1 7 0 0 0 0 0 11 15 1 2 2 14 10 0 0 0 0 0 0 11 15 1 1 1 7 0 0 0 0 0 11 15 2 2 2 1 2 13 9 0 0 0 0 
0 0 0 0 0 0 0 0 11 15 1 2 2 2 2 2 1 7 0 0 0 0 0 0 11 15 1 14 10 0 0 0 0 0 0 0 0 11 15 1 1 13 9 0 0 0 0 0 5 1 1 14 15 2 1 7 0 0 0 0 
0 0 0 0 0 0 0 0 0 11 15 1 2 1 1 1 1 7 0 0 0 0 0 0 0 5 2 7 0 0 0 0 0 0 0 0 0 0 11 15 1 1 7 0 0 0 0 0 5 1 14 10 11 15 14 10 0 0 0 0 
0 0 0 0 0 0 0 0 0 0 5 1 1 2 1 1 14 10 0 0 0 0 0 0 0 5 1 13 9 0 0 0 0 0 0 0 0 0 0 5 1 1 7 0 0 0 0 8 12 1 7 0 0 11 10 0 0 0 0 0 
0 0 0 0 0 0 0 0 0 8 12 1 1 14 6 6 10 0 0 0 0 0 0 0 8 12 1 1 13 4 9 0 0 0 0 0 8 4 9 5 1 14 10 0 0 0 8 12 14 6 10 0 0 0 0 0 0 0 0 0 
0 0 0 0 0 0 0 8 4 12 1 1 14 10 0 0 0 0 0 0 0 0 0 8 12 1 2 2 1 1 7 0 0 0 0 8 12 1 13 12 1 7 0 0 8 4 12 1 7 0 0 0 0 8 9 0 0 0 0 0 
0 0 0 0 0 0 8 12 1 1 1 14 10 0 0 0 0 0 0 0 0 0 8 12 1 2 2 2 1 1 7 0 0 0 0 5 1 2 2 2 1 13 4 4 12 1 1 14 10 0 0 0 0 5 7 0 0 0 0 0 
0 0 0 0 0 8 12 2 2 1 1 7 8 9 0 0 0 0 0 0 8 4 12 1 2 2 1 2 1 14 10 0 0 0 8 12 1 2 2 2 1 1 1 1 1 1 14 10 0 0 0 0 8 12 13 9 0 0 0 0 
0 0 0 0 0 5 1 2 1 2 1 7 11 10 0 0 0 0 0 8 12 1 1 2 2 2 2 1 1 7 0 0 0 0 5 1 1 2 2 2 2 2 2 2 1 14 10 0 0 0 0 0 11 6 15 7 0 0 0 0 
0 0 0 0 0 5 1 2 2 2 1 13 4 4 9 0 0 8 4 12 1 2 2 1 1 1 1 1 1 13 9 0 0 8 12 1 1 2 1 1 1 2 2 1 1 13 9 0 0 0 0 0 0 0 11 10 0 0 0 0 
0 0 0 0 0 11 15 1 14 6 15 1 1 1 13 4 4 12 1 2 2 1 1 1 14 6 15 1 1 1 13 4 4 12 1 1 1 2 1 1 1 2 2 1 1 1 13 9 0 0 0 0 0 0 0 0 0 0 0 0 
0 0 0 0 0 0 11 6 10 0 11 15 1 1 2 2 1 1 2 2 1 14 6 6 10 0 11 15 1 1 1 1 1 1 1 14 6 6 15 2 2 2 2 1 1 1 1 13 9 0 0 0 0 0 0 0 0 0 0 0 
0 0 0 0 0 0 0 0 0 0 0 11 6 15 2 2 1 2 2 1 14 10 0 0 0 0 0 5 1 1 2 1 1 14 6 10 0 0 11 15 1 2 1 1 1 1 2 1 13 4 4 4 4 4 9 0 0 0 0 0 
0 0 0 0 0 0 0 0 0 0 0 0 8 12 1 2 1 2 1 1 7 0 0 0 0 0 0 11 15 1 2 1 1 13 9 0 0 0 0 11 6 15 2 2 2 2 2 1 1 1 1 2 2 1 13 9 0 0 0 0 
0 0 0 0 0 0 0 0 0 8 4 4 12 1 1 1 2 1 1 14 10 0 0 0 0 0 0 8 12 1 2 1 1 1 13 9 0 0 0 0 0 11 6 15 1 2 14 6 6 15 1 1 2 2 1 13 4 9 0 0 
0 0 0 0 0 0 0 8 4 12 2 1 1 1 1 1 1 1 14 10 0 0 0 0 8 4 4 12 2 2 2 1 1 1 14 10 0 0 0 0 0 0 0 5 1 1 7 0 0 11 6 15 1 2 2 2 2 7 0 0 
0 0 0 0 0 0 8 12 1 2 2 1 1 1 14 6 6 6 10 0 0 0 8 4 12 1 1 1 1 1 14 22 18 6 10 0 0 0 0 0 0 0 8 12 1 1 7 0 0 0 0 11 15 1 1 14 6 10 0 0 
0 0 0 0 0 0 5 1 2 2 1 2 1 14 10 0 0 0 0 0 0 8 12 2 1 2 1 1 14 6 10 0 0 0 0 0 0 0 0 0 0 8 12 1 1 14 10 0 0 0 0 0 5 1 14 10 0 0 0 0 
0 0 0 0 0 8 12 1 2 1 2 2 1 7 0 0 0 0 0 0 8 12 2 2 2 2 14 6 10 0 0 0 0 0 0 0 0 0 0 0 8 12 1 1 1 7 0 0 0 0 0 8 12 1 7 0 0 0 0 0 
0 0 0 0 0 5 1 1 2 2 2 2 1 7 0 0 0 0 0 0 5 1 2 2 14 6 10 0 0 0 0 0 0 0 0 0 0 8 4 4 12 1 14 6 6 10 0 0 0 0 0 5 1 1 7 0 0 0 0 0 
0 0 0 0 0 11 15 1 1 2 2 2 1 7 0 0 0 0 0 8 12 1 1 14 10 0 0 0 0 0 0 0 0 0 0 0 8 12 2 14 6 6 10 0 0 0 0 0 0 0 0 5 2 14 10 0 0 0 0 0 
0 0 0 0 0 0 11 15 1 1 1 2 1 13 4 9 0 0 8 12 1 14 6 10 0 0 0 0 8 4 4 9 0 0 0 0 11 6 6 10 0 0 0 0 0 8 9 0 0 0 0 5 1 7 0 0 0 0 0 0 
0 0 0 0 0 0 0 11 15 14 15 1 2 1 1 13 9 0 5 1 14 10 0 0 0 0 0 8 12 1 1 13 4 9 0 0 0 0 0 0 0 0 8 4 9 5 7 0 0 0 8 12 2 7 0 0 0 0 0 0 
0 0 0 0 0 0 0 0 11 10 5 1 2 2 2 1 13 4 12 1 7 0 0 0 0 0 8 12 2 2 2 2 2 7 0 0 0 0 0 0 0 8 12 2 7 11 10 0 0 8 12 1 2 13 9 0 0 0 0 0 
0 0 0 0 0 0 0 0 0 0 11 15 1 1 1 1 2 1 1 1 7 0 0 0 0 0 11 15 2 1 1 1 2 7 0 0 0 0 0 0 8 12 1 14 10 0 0 0 8 12 2 1 14 15 13 9 0 0 0 0 
0 0 0 0 0 0 0 0 0 0 0 11 6 6 15 1 2 2 1 1 7 0 0 0 0 0 0 5 2 2 1 1 14 10 0 0 0 0 0 0 5 2 14 10 0 0 8 4 12 1 14 6 10 5 1 13 9 0 0 0 
0 0 0 0 0 0 0 0 0 0 0 0 0 0 11 15 1 2 2 2 13 9 0 0 0 0 0 11 15 2 1 14 10 0 0 0 0 0 0 0 5 1 13 9 0 8 12 1 14 6 10 0 0 5 1 1 7 0 0 0 
0 0 0 0 8 4 9 0 0 0 0 0 0 0 0 5 1 2 1 1 1 13 9 0 0 0 0 0 5 1 14 10 0 0 0 8 4 9 0 0 11 15 1 13 9 5 1 2 7 0 0 0 0 5 2 2 7 0 0 0 
0 0 8 4 12 14 10 0 0 0 0 0 0 0 0 11 15 1 2 2 1 1 7 0 0 0 0 0 5 1 7 0 0 0 8 12 14 10 0 0 0 11 15 1 13 12 2 14 10 0 0 0 8 12 2 1 13 9 0 0 
0 0 5 2 14 10 0 0 0 8 9 0 0 0 0 0 11 15 1 2 2 14 10 0 0 0 0 8 12 14 10 0 0 0 5 1 13 9 0 0 0 0 11 15 1 1 1 7 0 0 0 8 12 2 2 1 1 13 9 0 
0 8 12 14 10 0 0 0 8 12 13 9 0 0 0 0 0 5 1 2 1 7 0 0 0 0 0 5 1 7 0 0 0 0 11 15 1 13 9 0 0 0 0 5 2 2 14 10 0 0 0 5 2 2 1 1 1 1 7 0 
0 5 1 7 0 0 0 8 12 1 1 13 9 0 0 0 8 12 1 2 14 10 0 0 0 0 8 12 2 7 0 0 0 0 0 5 1 2 13 9 0 0 0 5 1 14 10 0 0 0 8 12 2 14 6 15 2 2 7 0 
0 5 2 7 0 0 0 11 15 1 2 2 13 4 9 8 12 2 1 14 10 0 0 0 0 0 5 1 14 10 0 0 0 0 8 12 2 2 1 7 0 0 0 5 1 13 9 0 0 0 5 1 14 10 0 5 2 1 7 0 
0 11 15 13 9 0 0 0 11 15 1 2 1 1 13 12 1 2 1 7 0 0 0 0 8 4 12 1 7 0 0 0 0 8 12 1 2 1 1 13 9 0 0 11 15 1 13 9 0 0 11 6 10 0 0 5 2 2 7 0 
0 0 11 15 13 9 0 0 0 11 6 6 15 1 1 1 1 2 14 10 0 0 0 0 5 1 2 2 7 0 0 0 8 12 1 2 14 6 15 1 7 0 0 0 5 1 1 13 9 0 0 0 0 0 8 12 1 1 7 0 
0 0 0 11 15 7 0 0 0 0 0 0 11 6 6 15 1 1 7 0 0 0 0 8 12 2 1 14 10 0 0 8 12 1 1 14 10 0 11 15 13 9 0 0 11 15 1 14 10 0 0 0 0 0 5 1 1 14 10 0 
0 0 0 0 11 10 0 0 0 0 0 0 0 0 0 11 15 14 10 0 0 0 0 5 1 1 14 10 0 0 8 12 1 2 14 10 0 0 0 5 1 13 9 0 0 11 6 10 0 0 0 0 8 4 12 2 14 10 0 0 
0 0 0 0 0 0 0 0 8 9 0 0 0 0 0 0 11 10 0 0 0 0 8 12 2 1 7 0 0 0 5 2 1 2 7 0 0 0 8 12 2 2 7 0 0 0 0 0 0 0 0 0 5 1 14 6 10 0 0 0 
0 0 0 0 0 0 0 8 12 13 9 0 0 0 0 0 0 0 0 0 0 0 5 1 2 14 10 0 0 0 5 1 1 14 10 0 0 8 12 1 2 14 10 0 0 0 0 0 0 0 8 4 12 14 10 0 0 0 0 0 
0 0 0 0 0 0 8 12 1 1 7 0 0 0 0 0 0 0 0 0 8 4 12 1 14 10 0 0 0 8 12 2 14 10 0 0 0 5 2 1 14 10 0 0 0 0 8 4 4 4 12 2 1 7 0 0 0 0 0 0 
0 0 0 0 0 0 11 15 2 2 13 9 0 0 0 8 4 4 4 4 12 2 2 1 7 0 0 0 8 12 1 2 13 9 0 0 0 5 2 2 7 0 0 0 8 4 12 2 2 2 1 1 14 10 0 0 0 0 0 0 
0 0 0 0 0 0 0 11 15 2 2 13 9 0 0 5 2 2 2 1 1 1 2 1 13 9 0 8 12 1 1 2 1 7 0 0 0 5 1 2 7 0 0 0 11 15 1 2 2 1 1 1 13 9 0 0 0 0 0 0 
0 0 0 0 0 0 0 0 11 15 2 2 13 9 8 12 2 2 1 1 14 15 2 2 1 13 4 12 2 14 6 15 2 13 9 0 0 11 15 1 13 9 0 0 0 11 6 15 14 6 15 1 1 13 9 0 0 0 0 0 
0 0 0 0 0 0 0 0 0 5 1 2 1 13 12 1 2 2 1 14 10 5 1 2 2 1 1 1 1 7 0 11 15 1 13 9 0 0 5 2 1 7 0 0 0 0 0 11 10 0 11 15 2 1 13 9 0 0 0 0 
0 0 0 0 0 0 0 0 0 11 15 2 1 1 2 2 1 14 6 10 0 11 15 1 1 2 1 1 14 10 0 0 5 2 2 7 0 0 11 15 1 13 9 0 0 0 0 0 0 0 0 5 2 2 1 7 0 0 0 0 
0 0 0 0 0 0 0 0 0 0 5 2 2 2 2 1 14 10 0 0 0 0 11 6 15 2 1 14 10 0 0 0 11 15 1 7 0 0 0 5 1 2 13 9 8 4 4 4 9 0 8 12 1 2 2 7 0 0 0 0 
0 0 0 0 0 0 0 0 0 0 11 15 1 1 14 6 10 0 0 0 0 0 0 0 5 2 14 10 0 0 0 0 0 11 6 10 0 0 0 11 15 1 1 13 12 1 2 1 13 4 12 1 1 1 14 10 0 0 0 0 
0 0 0 0 0 0 0 0 0 0 0 11 22 18 10 0 0 0 0 0 0 0 0 0 11 6 10 0 0 0 0 0 0 0 0 8 9 0 0 0 11 6 6 6 6 6 6 15 2 1 1 2 14 6 10 0 0 0 0 0 
0 0 0 0 0 0 0 0 0 0 0 0 0 0 0 0 0 0 0 0 0 0 0 0 0 0 0 0 0 0 0 0 0 0 0 11 10 0 0 0 0 0 0 0 0 0 0 11 6 6 15 1 7 0 0 0 0 0 0 0 
0 0 0 0 0 0 0 0 0 0 0 0 0 0 0 0 0 0 0 0 0 0 0 0 0 0 0 0 0 0 0 0 0 0 0 0 0 0 0 0 0 0 0 0 0 0 0 0 0 0 11 6 10 0 0 0 0 0 0 0 
0 0 0 0 0 0 0 0 0 0 0 0 0 0 0 0 0 0 0 0 0 0 0 0 0 0 0 0 0 0 0 0 0 0 0 0 0 0 0 0 0 0 0 0 0 0 0 0 0 0 0 0 0 0 0 0 0 0 0 0 

[COLLISION]
0 0 0 0 0 0 0 0 0 0 0 0 0 0 0 0 0 0 0 0 0 0 0 0 0 0 0 0 0 0 0 0 0 0 0 0 0 0 0 0 0 0 0 0 0 0 0 0 0 0 0 0 0 0 0 0 0 0 0 0 
0 0 0 0 0 0 0 0 0 0 0 0 0 0 0 0 0 0 0 0 0 0 0 0 0 0 0 0 0 0 0 0 0 0 0 0 0 0 0 0 0 0 0 0 0 0 0 0 0 0 0 0 0 0 0 0 0 0 0 0 
0 0 0 0 0 0 0 0 0 0 0 0 0 0 0 0 0 0 0 0 0 0 0 0 0 0 0 0 0 0 0 0 0 0 0 0 0 0 0 0 0 0 0 0 0 0 0 0 0 0 0 0 0 0 6 2 7 0 0 0 
0 0 0 0 0 0 0 0 0 0 0 0 0 0 0 0 0 0 6 7 0 0 0 0 0 0 0 0 0 0 0 0 0 0 0 6 2 2 7 0 0 0 0 0 0 0 0 0 0 0 0 0 0 6 13 0 3 0 0 0 
0 0 0 0 0 0 0 0 0 0 0 0 0 0 0 0 0 0 5 3 0 0 0 0 6 2 2 7 0 0 0 0 0 6 2 13 0 0 12 7 0 0 0 0 0 6 2 7 0 0 6 2 2 13 10 4 9 0 0 0 
0 0 0 0 0 0 0 0 6 2 7 0 0 0 0 0 0 0 5 3 0 0 0 0 5 0 0 12 2 2 2 2 2 13 0 0 0 0 0 12 7 0 0 0 0 5 0 12 2 2 13 0 0 10 9 0 0 0 0 0 
0 0 0 0 0 0 0 6 13 0 12 7 0 0 0 0 0 0 5 12 7 0 0 6 13 0 0 0 0 0 0 0 0 0 0 0 0 0 0 0 3 0 0 0 0 8 4 11 0 0 0 0 0 3 0 0 0 0 0 0 
0 0 0 0 0 0 6 13 0 0 0 3 0 0 0 0 0 0 8 11 3 0 0 5 0 0 0 0 0 0 10 4 11 10 4 4 11 0 0 0 3 0 0 0 0 0 0 5 0 0 0 0 0 3 0 0 0 0 0 0 
0 0 0 0 0 0 5 0 0 0 0 12 2 2 2 2 2 7 0 8 9 0 0 5 0 0 0 0 0 10 9 0 8 9 0 0 5 0 0 0 12 7 0 0 0 0 0 5 0 0 0 0 0 12 7 0 0 0 0 0 
0 0 0 0 0 0 8 4 11 0 0 0 0 0 0 0 0 3 0 0 0 0 0 8 11 0 0 0 10 9 0 0 0 0 0 0 8 11 0 0 0 3 0 0 0 0 0 8 11 0 0 0 0 0 12 7 0 0 0 0 
0 0 0 0 0 0 0 0 8 11 0 0 0 0 0 0 0 3 0 0 0 0 0 0 8 11 0 10 9 0 0 0 0 0 0 0 0 8 11 0 0 12 7 0 0 0 0 0 5 0 0 10 11 0 0 3 0 0 0 0 
0 0 0 0 0 0 0 0 0 8 11 0 0 0 0 0 0 3 0 0 0 0 0 0 0 5 0 3 0 0 0 0 0 0 0 0 0 0 8 11 0 0 3 0 0 0 0 0 5 0 10 9 8 11 10 9 0 0 0 0 
0 0 0 0 0 0 0 0 0 0 5 0 0 0 0 0 10 9 0 0 0 0 0 0 0 5 0 12 7 0 0 0 0 0 0 0 0 0 0 5 0 0 3 0 0 0 0 6 13 0 3 0 0 8 9 0 0 0 0 0 
0 0 0 0 0 0 0 0 0 6 13 0 0 10 4 4 9 0 0 0 0 0 0 0 6 13 0 0 12 2 7 0 0 0 0 0 6 2 7 5 0 10 9 0 0 0 6 13 10 4 9 0 0 0 0 0 0 0 0 0 
0 0 0 0 0 0 0 6 2 13 0 0 10 9 0 0 0 0 0 0 0 0 0 6 13 0 0 0 0 0 3 0 0 0 0 6 13 0 12 13 0 3 0 0 6 2 13 0 3 0 0 0 0 6 7 0 0 0 0 0 
0 0 0 0 0 0 6 13 0 0 0 10 9 0 0 0 0 0 0 0 0 0 6 13 0 0 0 0 0 0 3 0 0 0 0 5 0 0 0 0 0 12 2 2 13 0 0 10 9 0 0 0 0 5 3 0 0 0 0 0 
0 0 0 0 0 6 13 0 0 0 0 3 6 7 0 0 0 0 0 0 6 2 13 0 0 0 0 0 0 10 9 0 0 0 6 13 0 0 0 0 0 0 0 0 0 0 10 9 0 0 0 0 6 13 12 7 0 0 0 0 
0 0 0 0 0 5 0 0 0 0 0 3 8 9 0 0 0 0 0 6 13 0 0 0 0 0 0 0 0 3 0 0 0 0 5 0 0 0 0 0 0 0 0 0 0 10 9 0 0 0 0 0 8 4 11 3 0 0 0 0 
0 0 0 0 0 5 0 0 0 0 0 12 2 2 7 0 0 6 2 13 0 0 0 0 0 0 0 0 0 12 7 0 0 6 13 0 0 0 0 0 0 0 0 0 0 12 7 0 0 0 0 0 0 0 8 9 0 0 0 0 
0 0 0 0 0 8 11 0 10 4 11 0 0 0 12 2 2 13 0 0 0 0 0 0 10 4 11 0 0 0 12 2 2 13 0 0 0 0 0 0 0 0 0 0 0 0 12 7 0 0 0 0 0 0 0 0 0 0 0 0 
0 0 0 0 0 0 8 4 9 0 8 11 0 0 0 0 0 0 0 0 0 10 4 4 9 0 8 11 0 0 0 0 0 0 0 10 4 4 11 0 0 0 0 0 0 0 0 12 7 0 0 0 0 0 0 0 0 0 0 0 
0 0 0 0 0 0 0 0 0 0 0 8 4 11 0 0 0 0 0 0 10 9 0 0 0 0 0 5 0 0 0 0 0 10 4 9 0 0 8 11 0 0 0 0 0 0 0 0 12 2 2 2 2 2 7 0 0 0 0 0 
0 0 0 0 0 0 0 0 0 0 0 0 6 13 0 0 0 0 0 0 3 0 0 0 0 0 0 8 11 0 0 0 0 12 7 0 0 0 0 8 4 11 0 0 0 0 0 0 0 0 0 0 0 0 12 7 0 0 0 0 
0 0 0 0 0 0 0 0 0 6 2 2 13 0 0 0 0 0 0 10 9 0 0 0 0 0 0 6 13 0 0 0 0 0 12 7 0 0 0 0 0 8 4 11 0 0 10 4 4 11 0 0 0 0 0 12 2 7 0 0 
0 0 0 0 0 0 0 6 2 13 0 0 0 0 0 0 0 0 10 9 0 0 0 0 6 2 2 13 0 0 0 0 0 0 10 9 0 0 0 0 0 0 0 5 0 0 3 0 0 8 4 11 0 0 0 0 0 3 0 0 
0 0 0 0 0 0 6 13 0 0 0 0 0 0 10 4 4 4 9 0 0 0 6 2 13 0 0 0 0 0 10 0 0 4 9 0 0 0 0 0 0 0 6 13 0 0 3 0 0 0 0 8 11 0 0 10 4 9 0 0 
0 0 0 0 0 0 5 0 0 0 0 0 0 10 9 0 0 0 0 0 0 6 13 0 0 0 0 0 10 4 9 1 1 0 0 0 0 0 0 0 0 6 13 0 0 10 9 0 0 0 0 0 5 0 10 9 0 0 0 0 
0 0 0 0 0 6 13 0 0 0 0 0 0 3 0 0 0 0 0 0 6 13 0 0 0 0 10 4 9 0 0 0 0 0 0 0 0 0 0 0 6 13 0 0 0 3 0 0 0 0 0 6 13 0 3 0 0 0 0 0 
0 0 0 0 0 5 0 0 0 0 0 0 0 3 0 0 0 0 0 0 5 0 0 0 10 4 9 0 0 0 0 0 0 0 0 0 0 6 2 2 13 0 10 4 4 9 0 0 0 0 0 5 0 0 3 0 0 0 0 0 
0 0 0 0 0 8 11 0 0 0 0 0 0 3 0 0 0 0 0 6 13 0 0 10 9 0 0 0 0 0 0 0 0 0 0 0 6 13 0 10 4 4 9 0 0 0 0 0 0 0 0 5 0 10 9 0 0 0 0 0 
0 0 0 0 0 0 8 11 0 0 0 0 0 12 2 7 0 0 6 13 0 10 4 9 0 0 0 0 6 2 2 7 0 0 0 0 8 4 4 9 0 0 0 0 0 6 7 0 0 0 0 5 0 3 0 0 0 0 0 0 
0 0 0 0 0 0 0 8 11 10 11 0 0 0 0 12 7 0 5 0 10 9 0 0 0 0 0 6 13 0 0 12 2 7 0 0 0 0 0 0 0 0 6 2 7 5 3 0 0 0 6 13 0 3 0 0 0 0 0 0 
0 0 0 0 0 0 0 0 8 9 5 0 0 0 0 0 12 2 13 0 3 0 0 0 0 0 6 13 0 0 0 0 0 3 0 0 0 0 0 0 0 6 13 0 3 8 9 0 0 6 13 0 0 12 7 0 0 0 0 0 
0 0 0 0 0 0 0 0 0 0 8 11 0 0 0 0 0 0 0 0 3 0 0 0 0 0 8 11 0 0 0 0 0 3 0 0 0 0 0 0 6 13 0 10 9 0 0 0 6 13 0 0 10 11 12 7 0 0 0 0 
0 0 0 0 0 0 0 0 0 0 0 8 4 4 11 0 0 0 0 0 3 0 0 0 0 0 0 5 0 0 0 0 10 9 0 0 0 0 0 0 5 0 10 9 0 0 6 2 13 0 10 4 9 5 0 12 7 0 0 0 
0 0 0 0 0 0 0 0 0 0 0 0 0 0 8 11 0 0 0 0 12 7 0 0 0 0 0 8 11 0 0 10 9 0 0 0 0 0 0 0 5 0 12 7 0 6 13 0 10 4 9 0 0 5 0 0 3 0 0 0 
0 0 0 0 6 2 7 0 0 0 0 0 0 0 0 5 0 0 0 0 0 12 7 0 0 0 0 0 5 0 10 9 0 0 0 6 2 7 0 0 8 11 0 12 7 5 0 0 3 0 0 0 0 5 0 0 3 0 0 0 
0 0 6 2 13 10 9 0 0 0 0 0 0 0 0 8 11 0 0 0 0 0 3 0 0 0 0 0 5 0 3 0 0 0 6 13 10 9 0 0 0 8 11 0 12 13 0 10 9 0 0 0 6 13 0 0 12 7 0 0 
0 0 5 0 10 9 0 0 0 6 7 0 0 0 0 0 8 11 0 0 0 10 9 0 0 0 0 6 13 10 9 0 0 0 5 0 12 7 0 0 0 0 8 11 0 0 0 3 0 0 0 6 13 0 0 0 0 12 7 0 
0 6 13 10 9 0 0 0 6 13 12 7 0 0 0 0 0 5 0 0 0 3 0 0 0 0 0 5 0 3 0 0 0 0 8 11 0 12 7 0 0 0 0 5 0 0 10 9 0 0 0 5 0 0 0 0 0 0 3 0 
0 5 0 3 0 0 0 6 13 0 0 12 7 0 0 0 6 13 0 0 10 9 0 0 0 0 6 13 0 3 0 0 0 0 0 5 0 0 12 7 0 0 0 5 0 10 9 0 0 0 6 13 0 10 4 11 0 0 3 0 
0 5 0 3 0 0 0 8 11 0 0 0 12 2 7 6 13 0 0 10 9 0 0 0 0 0 5 0 10 9 0 0 0 0 6 13 0 0 0 3 0 0 0 5 0 12 7 0 0 0 5 0 10 9 0 5 0 0 3 0 
0 8 11 12 7 0 0 0 8 11 0 0 0 0 12 13 0 0 0 3 0 0 0 0 6 2 13 0 3 0 0 0 0 6 13 0 0 0 0 12 7 0 0 8 11 0 12 7 0 0 8 4 9 0 0 5 0 0 3 0 
0 0 8 11 12 7 0 0 0 8 4 4 11 0 0 0 0 0 10 9 0 0 0 0 5 0 0 0 3 0 0 0 6 13 0 0 10 4 11 0 3 0 0 0 5 0 0 12 7 0 0 0 0 0 6 13 0 0 3 0 
0 0 0 8 11 3 0 0 0 0 0 0 8 4 4 11 0 0 3 0 0 0 0 6 13 0 0 10 9 0 0 6 13 0 0 10 9 0 8 11 12 7 0 0 8 11 0 10 9 0 0 0 0 0 5 0 0 10 9 0 
0 0 0 0 8 9 0 0 0 0 0 0 0 0 0 8 11 10 9 0 0 0 0 5 0 0 10 9 0 0 6 13 0 0 10 9 0 0 0 5 0 12 7 0 0 8 4 9 0 0 0 0 6 2 13 0 10 9 0 0 
0 0 0 0 0 0 0 0 6 7 0 0 0 0 0 0 8 9 0 0 0 0 6 13 0 0 3 0 0 0 5 0 0 0 3 0 0 0 6 13 0 0 3 0 0 0 0 0 0 0 0 0 5 0 10 4 9 0 0 0 
0 0 0 0 0 0 0 6 13 12 7 0 0 0 0 0 0 0 0 0 0 0 5 0 0 10 9 0 0 0 5 0 0 10 9 0 0 6 13 0 0 10 9 0 0 0 0 0 0 0 6 2 13 10 9 0 0 0 0 0 
0 0 0 0 0 0 6 13 0 0 3 0 0 0 0 0 0 0 0 0 6 2 13 0 10 9 0 0 0 6 13 0 10 9 0 0 0 5 0 0 10 9 0 0 0 0 6 2 2 2 13 0 0 3 0 0 0 0 0 0 
0 0 0 0 0 0 8 11 0 0 12 7 0 0 0 6 2 2 2 2 13 0 0 0 3 0 0 0 6 13 0 0 12 7 0 0 0 5 0 0 3 0 0 0 6 2 13 0 0 0 0 0 10 9 0 0 0 0 0 0 
0 0 0 0 0 0 0 8 11 0 0 12 7 0 0 5 0 0 0 0 0 0 0 0 12 7 0 6 13 0 0 0 0 3 0 0 0 5 0 0 3 0 0 0 8 11 0 0 0 0 0 0 12 7 0 0 0 0 0 0 
0 0 0 0 0 0 0 0 8 11 0 0 12 7 6 13 0 0 0 0 10 11 0 0 0 12 2 13 0 10 4 11 0 12 7 0 0 8 11 0 12 7 0 0 0 8 4 11 10 4 11 0 0 12 7 0 0 0 0 0 
0 0 0 0 0 0 0 0 0 5 0 0 0 12 13 0 0 0 0 10 9 5 0 0 0 0 0 0 0 3 0 8 11 0 12 7 0 0 5 0 0 3 0 0 0 0 0 8 9 0 8 11 0 0 12 7 0 0 0 0 
0 0 0 0 0 0 0 0 0 8 11 0 0 0 0 0 0 10 4 9 0 8 11 0 0 0 0 0 10 9 0 0 5 0 0 3 0 0 8 11 0 12 7 0 0 0 0 0 0 0 0 5 0 0 0 3 0 0 0 0 
0 0 0 0 0 0 0 0 0 0 5 0 0 0 0 0 10 9 0 0 0 0 8 4 11 0 0 10 9 0 0 0 8 11 0 3 0 0 0 5 0 0 12 7 6 2 2 2 7 0 6 13 0 0 0 3 0 0 0 0 
0 0 0 0 0 0 0 0 0 0 8 11 0 0 10 4 9 0 0 0 0 0 0 0 5 0 10 9 0 0 0 0 0 8 4 9 0 0 0 8 11 0 0 12 13 0 0 0 12 2 13 0 0 0 10 9 0 0 0 0 
0 0 0 0 0 0 0 0 0 0 0 8 0 0 9 0 0 0 0 0 0 0 0 0 8 4 9 0 0 0 0 0 0 0 0 6 7 0 0 0 8 4 4 4 4 4 4 11 0 0 0 0 10 4 9 0 0 0 0 0 
0 0 0 0 0 0 0 0 0 0 0 0 1 1 0 0 0 0 0 0 0 0 0 0 0 0 0 0 0 0 0 0 0 0 0 8 9 0 0 0 0 0 0 0 0 0 0 8 4 4 11 0 3 0 0 0 0 0 0 0 
0 0 0 0 0 0 0 0 0 0 0 0 0 0 0 0 0 0 0 0 0 0 0 0 0 0 0 0 0 0 0 0 0 0 0 0 0 0 0 0 0 0 0 0 0 0 0 0 0 0 8 4 9 0 0 0 0 0 0 0 
0 0 0 0 0 0 0 0 0 0 0 0 0 0 0 0 0 0 0 0 0 0 0 0 0 0 0 0 0 0 0 0 0 0 0 0 0 0 0 0 0 0 0 0 0 0 0 0 0 0 0 0 0 0 0 0 0 0 0 0 
