[TILESET]
TileSheet

[TERRAIN]
79 79 79 79 79 79 79 79 79 79 79 79 79 79 79 79 79 79 79 73 7 3 5 75 77 77 77 77 77 77 77 77 77 77 77 77 77 77 77 77 
79 79 79 79 79 79 79 79 79 79 79 79 79 79 79 79 79 79 99 90 7 3 5 75 77 77 77 77 77 77 77 77 77 77 77 77 77 77 77 77 
79 79 79 79 79 79 79 79 79 79 79 79 79 79 79 79 79 79 73 9 14 3 5 91 97 77 77 77 77 77 77 77 77 77 77 77 77 77 77 77 
79 79 79 79 79 79 79 79 79 79 79 79 79 79 79 79 79 99 90 7 3 3 5 2 75 77 77 77 77 77 77 77 77 77 77 77 77 77 77 77 
79 79 79 79 79 79 79 79 79 79 79 79 79 79 79 79 99 90 9 14 3 3 5 1 75 77 77 77 77 77 77 77 77 77 77 77 77 77 77 77 
79 79 79 79 79 79 79 79 79 79 79 79 79 79 99 74 90 9 14 13 4 12 15 8 91 97 77 77 77 77 77 77 77 77 77 77 77 77 77 77 
79 79 79 79 79 79 79 79 79 79 79 79 79 99 90 1 9 14 13 10 1 11 12 5 2 91 74 74 97 77 77 77 77 77 77 77 77 77 77 77 
79 79 79 79 79 79 79 79 79 79 79 79 79 73 1 2 11 4 10 89 88 1 11 10 1 2 9 8 91 74 97 77 77 77 77 77 77 77 77 77 
79 79 79 79 79 79 79 79 79 79 79 79 99 90 2 2 2 2 89 98 96 88 2 2 9 8 7 15 6 8 75 77 77 77 77 77 77 77 77 77 
79 79 79 79 79 79 79 79 79 79 99 74 90 9 8 2 1 89 98 77 79 96 88 2 11 10 11 12 3 5 91 97 77 77 77 77 77 77 77 77 
79 79 79 79 79 79 79 79 99 74 90 2 1 11 10 89 72 98 77 77 79 99 90 1 2 89 88 11 12 15 8 75 77 77 77 77 77 77 77 77 
79 79 79 79 79 79 79 99 90 9 8 2 2 89 72 98 77 77 77 77 79 73 9 8 89 98 96 88 11 12 5 91 97 77 77 77 77 77 77 77 
79 79 79 79 79 79 79 73 2 11 10 1 89 98 77 77 77 77 77 79 99 90 11 10 75 77 79 96 88 11 10 1 75 77 77 77 77 77 77 77 
79 79 79 79 79 79 79 73 1 2 2 2 91 97 77 77 77 77 77 79 73 9 8 1 75 77 79 79 73 1 2 2 91 97 77 77 77 77 77 77 
79 79 79 79 79 79 79 96 88 2 9 6 8 91 97 77 77 77 77 79 73 7 5 89 98 77 79 79 96 88 2 2 2 91 97 77 77 77 77 77 
79 79 79 79 79 79 79 79 73 2 7 3 15 8 91 74 97 77 77 79 73 11 10 75 77 77 77 79 99 90 2 2 2 1 75 77 77 77 77 77 
79 79 79 79 79 79 79 79 96 88 11 12 3 5 9 8 75 77 77 79 73 1 2 91 97 77 77 79 73 1 2 1 2 2 75 77 77 77 77 77 
79 79 79 79 79 79 79 79 79 96 88 11 4 10 11 10 91 97 77 79 96 88 2 2 91 97 77 99 90 9 8 2 2 89 98 77 77 77 77 77 
79 79 79 79 79 79 79 79 79 79 96 88 2 89 88 2 1 75 77 77 79 73 1 9 8 75 77 73 1 11 10 2 2 75 77 77 77 77 77 77 
79 79 79 79 79 79 79 79 79 79 99 90 1 75 96 88 2 75 77 77 79 96 88 7 5 91 97 73 2 2 2 1 89 98 77 77 77 77 77 77 
79 79 79 79 79 79 79 79 79 99 90 2 89 98 79 96 88 91 97 77 79 79 73 11 10 1 91 90 2 2 2 89 98 77 77 77 77 77 77 77 
79 79 79 79 79 79 79 79 79 73 1 89 98 77 79 79 73 2 75 77 77 79 96 88 2 9 6 6 8 2 2 75 77 77 77 77 77 77 77 77 
79 79 79 79 79 79 79 79 99 90 2 75 77 77 79 99 90 2 75 77 77 79 79 73 9 14 3 13 10 1 89 98 77 77 77 77 77 77 77 77 
79 79 79 79 79 79 79 79 73 9 8 75 77 77 79 73 2 1 75 77 77 79 79 73 7 13 4 10 89 72 98 77 77 77 77 77 77 77 77 77 
79 79 79 79 79 79 79 99 90 7 5 91 97 77 99 90 1 89 98 77 79 79 99 90 11 10 89 72 98 77 77 77 77 77 77 77 77 77 77 77 
79 79 79 79 79 79 79 73 9 14 15 8 91 97 73 1 2 75 77 77 79 99 90 1 2 89 98 77 77 77 77 77 77 77 77 77 77 77 77 77 
79 79 79 79 79 79 99 90 7 13 4 10 1 91 90 2 89 98 77 77 79 73 2 1 2 75 77 77 77 77 77 77 77 77 77 77 77 77 77 77 
79 79 79 79 79 99 90 2 11 10 89 88 1 2 89 72 98 77 77 79 79 73 9 8 1 75 77 77 77 77 77 77 77 77 77 77 77 77 77 77 
79 79 79 79 79 73 1 2 2 89 98 96 72 72 98 77 77 77 77 79 99 90 7 5 2 75 77 77 77 77 77 77 77 77 77 77 77 77 77 77 
79 79 79 79 79 73 1 2 89 98 77 77 77 77 77 77 77 77 79 79 73 9 14 5 89 98 77 77 77 77 77 77 77 77 77 77 77 77 77 77 
79 79 79 79 79 73 2 2 91 97 77 77 77 77 77 77 77 79 79 79 73 7 13 10 75 77 77 77 77 77 77 77 77 77 77 77 77 77 77 77 
79 79 79 79 79 96 88 2 2 91 97 77 77 77 76 76 77 79 79 79 73 7 5 1 75 77 77 77 77 77 77 77 77 77 77 77 77 77 77 77 
79 79 79 79 79 79 96 88 2 1 75 77 77 76 76 76 76 79 99 74 90 11 10 89 98 77 77 77 77 77 77 77 77 77 77 77 77 77 77 77 
79 79 79 79 79 79 79 73 2 2 91 97 76 76 76 76 76 76 73 1 2 2 1 75 77 77 77 77 77 77 77 77 77 77 77 77 77 77 77 77 
79 79 79 79 79 79 79 96 88 2 2 91 97 76 76 76 76 99 90 9 6 8 2 75 77 77 77 77 77 99 74 74 74 97 77 77 77 77 77 77 
79 79 79 79 79 79 79 79 73 1 2 1 91 74 97 76 99 90 1 7 13 10 2 75 77 77 77 99 74 90 9 6 8 91 97 77 77 77 77 77 
79 79 79 79 79 79 79 79 73 2 2 2 2 2 91 74 90 9 6 14 5 1 89 98 77 77 99 90 9 6 14 3 15 8 91 97 77 77 77 77 
79 79 79 79 79 79 79 79 96 72 88 2 2 1 2 9 8 11 12 3 5 2 75 77 77 77 73 9 14 13 12 3 3 15 8 75 77 77 77 77 
79 79 79 79 79 79 79 79 79 79 73 2 2 2 9 14 15 6 14 3 15 8 75 77 99 74 90 7 13 10 11 4 12 3 5 91 97 77 77 77 
79 79 79 79 79 79 79 79 79 79 96 88 1 2 7 3 3 3 3 3 3 15 121 38 43 1 9 14 5 1 2 2 7 3 15 8 85 77 77 77 
79 79 79 79 79 79 79 79 79 79 79 73 1 2 11 4 4 12 3 3 3 3 44 38 43 2 7 3 15 8 1 9 14 3 3 5 93 77 77 77 
79 79 79 79 79 79 79 79 79 79 79 96 72 88 2 2 1 7 3 3 13 12 44 38 43 2 11 12 3 15 6 14 3 13 4 10 75 77 77 77 
79 79 79 79 79 79 79 79 79 79 79 79 79 96 72 88 2 11 12 3 5 11 120 38 43 1 2 11 12 3 3 13 4 10 1 89 98 77 77 77 
79 79 79 79 79 79 79 79 79 79 79 79 79 79 79 96 88 2 7 3 15 8 75 77 96 88 1 2 11 4 4 10 2 2 89 98 77 77 77 77 
79 79 79 79 79 79 79 79 79 79 79 79 79 79 79 79 96 88 11 12 3 5 75 77 77 96 72 88 1 2 2 1 89 72 98 77 77 77 77 77 
79 79 79 79 79 79 79 79 79 79 79 79 79 79 79 79 99 90 2 11 4 10 75 77 77 77 77 96 72 72 72 72 98 77 77 77 77 77 77 77 
79 79 79 79 79 79 79 79 79 79 79 79 79 79 79 99 90 1 2 2 2 2 91 97 77 77 77 77 77 77 77 77 77 77 77 77 77 77 77 77 
79 79 79 79 79 79 79 79 79 79 79 79 79 79 99 90 2 9 6 6 6 8 1 75 77 77 77 77 77 77 77 77 77 77 77 77 77 77 77 77 
79 79 79 79 79 79 79 79 79 79 79 79 79 79 73 2 2 7 3 3 3 15 8 91 97 77 77 77 77 77 77 77 77 77 77 77 77 77 77 77 
79 79 79 79 79 79 79 99 74 74 97 79 79 99 90 9 8 7 3 13 4 12 15 8 91 97 77 77 77 77 77 77 77 77 77 77 77 77 77 77 
79 79 79 79 79 99 74 90 2 1 91 97 79 73 9 14 5 11 12 15 8 7 3 5 2 75 77 77 77 77 77 77 77 77 77 77 77 77 77 77 
79 79 79 79 99 90 9 8 1 2 2 75 99 90 11 4 10 1 11 12 15 14 3 15 8 91 97 77 77 77 77 77 77 77 77 77 77 77 77 77 
79 79 79 79 73 1 11 10 9 6 8 91 90 2 89 72 88 1 1 7 3 3 3 3 5 1 91 97 77 77 77 77 77 77 77 77 77 77 77 77 
79 79 79 99 90 1 9 6 14 3 15 8 2 89 98 79 96 88 2 11 4 12 3 3 5 1 2 75 77 77 77 77 77 77 77 77 77 77 77 77 
79 79 79 73 2 9 14 3 3 3 3 5 1 75 79 79 79 96 72 88 2 11 4 4 10 2 89 98 77 77 77 77 77 77 77 77 77 77 77 77 
79 79 79 95 2 7 3 3 3 3 3 15 8 91 97 79 79 79 79 96 88 1 1 2 89 72 98 77 77 77 77 77 77 77 77 77 77 77 77 77 
79 79 79 87 1 11 12 3 3 3 3 3 5 2 75 79 79 79 79 79 96 88 1 1 91 97 77 77 77 77 77 77 77 77 77 77 77 77 77 77 
79 79 79 96 88 2 11 12 3 3 3 13 10 1 75 79 79 79 79 99 74 90 2 1 2 75 77 77 77 77 77 77 77 77 77 77 77 77 77 77 
79 79 79 79 96 88 1 11 4 4 4 10 89 72 98 79 79 79 79 73 1 2 9 8 2 91 97 77 77 77 77 77 77 77 77 77 77 77 77 77 
79 79 79 79 79 96 88 1 2 9 8 89 98 79 79 79 79 79 99 90 2 9 14 5 1 2 91 97 77 77 77 77 77 77 77 77 77 77 77 77 
79 79 79 79 79 79 96 72 88 11 10 75 79 79 79 79 79 99 90 2 9 14 3 5 2 1 1 91 97 77 77 77 77 77 77 77 77 77 77 77 
79 79 79 79 79 79 79 79 96 72 72 98 79 79 79 99 74 90 2 1 7 13 12 15 6 8 2 2 75 77 77 77 77 77 77 77 77 77 77 77 
79 79 79 79 79 79 79 79 79 79 79 79 79 79 79 73 2 9 6 6 14 15 14 3 3 15 8 2 91 74 97 77 77 77 77 77 77 77 77 77 
79 79 79 79 79 79 79 79 79 79 79 79 79 99 74 90 9 14 3 3 13 12 3 13 4 4 10 2 1 1 75 77 77 77 77 77 77 77 77 77 
79 79 79 79 79 79 79 79 79 79 79 79 79 73 1 2 7 3 13 12 5 7 13 10 1 1 2 89 72 72 98 77 77 77 77 77 77 77 77 77 
79 79 79 79 79 79 79 79 79 79 79 79 79 96 88 2 7 13 10 7 15 14 5 1 89 72 72 98 77 77 77 77 77 77 77 77 77 77 77 77 
79 79 79 79 79 79 79 79 79 79 79 79 79 79 73 2 11 10 2 11 12 13 10 89 98 77 77 77 77 77 77 77 77 77 77 77 77 77 77 77 
79 79 79 79 79 79 79 79 79 79 79 79 79 79 73 9 8 2 1 2 11 10 89 98 77 77 77 77 77 77 77 77 77 77 77 77 77 77 77 77 
79 79 79 79 79 79 79 79 79 79 79 79 79 79 73 11 10 1 1 2 1 2 75 77 77 77 77 77 77 77 77 77 77 77 77 77 77 77 77 77 
79 79 79 79 79 79 79 79 79 79 79 79 79 99 90 2 9 6 8 2 2 89 98 77 77 77 77 77 77 77 77 77 77 77 77 77 77 77 77 77 
79 79 79 79 79 79 79 79 79 79 79 79 79 73 2 1 7 3 15 8 1 75 77 77 77 77 77 77 77 77 77 77 77 77 77 77 77 77 77 77 
79 79 79 79 79 79 79 79 79 79 79 79 79 73 1 2 11 12 3 5 2 75 77 77 77 77 77 77 77 77 77 77 77 77 77 77 77 77 77 77 
79 79 79 79 79 79 79 79 79 79 79 79 79 96 88 9 8 11 4 10 89 98 77 77 77 77 77 77 77 77 77 77 77 77 77 77 77 77 77 77 
79 79 79 79 79 79 79 79 79 79 79 79 79 79 73 11 10 2 1 2 75 77 77 77 77 77 77 77 77 77 77 77 77 77 77 77 77 77 77 77 
79 79 79 79 79 79 79 79 79 79 79 79 79 79 96 88 2 1 2 89 98 77 77 77 77 77 77 77 77 77 77 77 77 77 77 77 77 77 77 77 
79 79 79 79 79 79 79 79 79 79 79 79 79 79 79 96 94 86 72 98 77 77 77 77 77 77 77 77 77 77 77 77 77 77 77 77 77 77 77 77 
79 79 79 79 79 79 79 79 79 79 79 79 79 79 79 79 79 77 77 77 77 77 77 77 77 77 77 77 77 77 77 77 77 77 77 77 77 77 77 77 
79 79 79 79 79 79 79 79 79 79 79 79 79 79 79 79 79 77 77 77 77 77 77 77 77 77 77 77 77 77 77 77 77 77 77 77 77 77 77 77 
79 79 79 79 79 79 79 79 79 79 79 79 79 79 79 79 79 77 77 77 77 77 77 77 77 77 77 77 77 77 77 77 77 77 77 77 77 77 77 77 
79 79 79 79 79 79 79 79 79 79 79 79 79 79 79 79 79 77 77 77 77 77 77 77 77 77 77 77 77 77 77 77 77 77 77 77 77 77 77 77 

[COLLISION]
0 0 0 0 0 0 0 0 0 0 0 0 0 0 0 0 0 0 0 5 0 0 0 3 0 0 0 0 0 0 0 0 0 0 0 0 0 0 0 0 
0 0 0 0 0 0 0 0 0 0 0 0 0 0 0 0 0 0 6 13 0 0 0 3 0 0 0 0 0 0 0 0 0 0 0 0 0 0 0 0 
0 0 0 0 0 0 0 0 0 0 0 0 0 0 0 0 0 0 5 0 0 0 0 12 7 0 0 0 0 0 0 0 0 0 0 0 0 0 0 0 
0 0 0 0 0 0 0 0 0 0 0 0 0 0 0 0 0 6 13 0 0 0 0 0 3 0 0 0 0 0 0 0 0 0 0 0 0 0 0 0 
0 0 0 0 0 0 0 0 0 0 0 0 0 0 0 0 6 13 0 0 0 0 0 0 3 0 0 0 0 0 0 0 0 0 0 0 0 0 0 0 
0 0 0 0 0 0 0 0 0 0 0 0 0 0 6 2 13 0 0 0 0 0 0 0 12 7 0 0 0 0 0 0 0 0 0 0 0 0 0 0 
0 0 0 0 0 0 0 0 0 0 0 0 0 6 13 0 0 0 0 0 0 0 0 0 0 12 2 2 7 0 0 0 0 0 0 0 0 0 0 0 
0 0 0 0 0 0 0 0 0 0 0 0 0 5 0 0 0 0 0 10 11 0 0 0 0 0 0 0 12 2 7 0 0 0 0 0 0 0 0 0 
0 0 0 0 0 0 0 0 0 0 0 0 6 13 0 0 0 0 10 9 8 11 0 0 0 0 0 0 0 0 3 0 0 0 0 0 0 0 0 0 
0 0 0 0 0 0 0 0 0 0 6 2 13 0 0 0 0 10 9 0 0 8 11 0 0 0 0 0 0 0 12 7 0 0 0 0 0 0 0 0 
0 0 0 0 0 0 0 0 6 2 13 0 0 0 0 10 4 9 0 0 0 6 13 0 0 10 11 0 0 0 0 3 0 0 0 0 0 0 0 0 
0 0 0 0 0 0 0 6 13 0 0 0 0 10 4 9 0 0 0 0 0 5 0 0 10 9 8 11 0 0 0 12 7 0 0 0 0 0 0 0 
0 0 0 0 0 0 0 5 0 0 0 0 10 9 0 0 0 0 0 0 6 13 0 0 3 0 0 8 11 0 0 0 3 0 0 0 0 0 0 0 
0 0 0 0 0 0 0 5 0 0 0 0 12 7 0 0 0 0 0 0 5 0 0 0 3 0 0 0 5 0 0 0 12 7 0 0 0 0 0 0 
0 0 0 0 0 0 0 8 11 0 0 0 0 12 7 0 0 0 0 0 5 0 0 10 9 0 0 0 8 11 0 0 0 12 7 0 0 0 0 0 
0 0 0 0 0 0 0 0 5 0 0 0 0 0 12 2 7 0 0 0 5 0 0 3 0 0 0 0 6 13 0 0 0 0 3 0 0 0 0 0 
0 0 0 0 0 0 0 0 8 11 0 0 0 0 0 0 3 0 0 0 5 0 0 12 7 0 0 0 5 0 0 0 0 0 3 0 0 0 0 0 
0 0 0 0 0 0 0 0 0 8 11 0 0 0 0 0 12 7 0 0 8 11 0 0 12 7 0 6 13 0 0 0 0 10 9 0 0 0 0 0 
0 0 0 0 0 0 0 0 0 0 8 11 0 10 11 0 0 3 0 0 0 5 0 0 0 3 0 5 0 0 0 0 0 3 0 0 0 0 0 0 
0 0 0 0 0 0 0 0 0 0 6 13 0 3 8 11 0 3 0 0 0 8 11 0 0 12 7 5 0 0 0 0 10 9 0 0 0 0 0 0 
0 0 0 0 0 0 0 0 0 6 13 0 10 9 0 8 11 12 7 0 0 0 5 0 0 0 12 13 0 0 0 10 9 0 0 0 0 0 0 0 
0 0 0 0 0 0 0 0 0 5 0 10 9 0 0 0 5 0 3 0 0 0 8 11 0 0 0 0 0 0 0 3 0 0 0 0 0 0 0 0 
0 0 0 0 0 0 0 0 6 13 0 3 0 0 0 6 13 0 3 0 0 0 0 5 0 0 0 0 0 0 10 9 0 0 0 0 0 0 0 0 
0 0 0 0 0 0 0 0 5 0 0 3 0 0 0 5 0 0 3 0 0 0 0 5 0 0 0 0 10 4 9 0 0 0 0 0 0 0 0 0 
0 0 0 0 0 0 0 6 13 0 0 12 7 0 6 13 0 10 9 0 0 0 6 13 0 0 10 4 9 0 0 0 0 0 0 0 0 0 0 0 
0 0 0 0 0 0 0 5 0 0 0 0 12 7 5 0 0 3 0 0 0 6 13 0 0 10 9 0 0 0 0 0 0 0 0 0 0 0 0 0 
0 0 0 0 0 0 6 13 0 0 0 0 0 12 13 0 10 9 0 0 0 5 0 0 0 3 0 0 0 0 0 0 0 0 0 0 0 0 0 0 
0 0 0 0 0 6 13 0 0 0 10 11 0 0 10 4 9 0 0 0 0 5 0 0 0 3 0 0 0 0 0 0 0 0 0 0 0 0 0 0 
0 0 0 0 0 5 0 0 0 10 9 8 4 4 9 0 0 0 0 0 6 13 0 0 0 3 0 0 0 0 0 0 0 0 0 0 0 0 0 0 
0 0 0 0 0 5 0 0 10 9 0 0 0 0 0 0 0 0 0 0 5 0 0 0 10 9 0 0 0 0 0 0 0 0 0 0 0 0 0 0 
0 0 0 0 0 5 0 0 12 7 0 0 0 0 0 0 0 0 0 0 5 0 0 0 3 0 0 0 0 0 0 0 0 0 0 0 0 0 0 0 
0 0 0 0 0 8 11 0 0 12 7 0 0 0 0 0 0 0 0 0 5 0 0 0 3 0 0 0 0 0 0 0 0 0 0 0 0 0 0 0 
0 0 0 0 0 0 8 11 0 0 3 0 0 0 0 0 0 0 6 2 13 0 0 10 9 0 0 0 0 0 0 0 0 0 0 0 0 0 0 0 
0 0 0 0 0 0 0 5 0 0 12 7 0 0 0 0 0 0 5 0 0 0 0 3 0 0 0 0 0 0 0 0 0 0 0 0 0 0 0 0 
0 0 0 0 0 0 0 8 11 0 0 12 7 0 0 0 0 6 13 0 0 0 0 3 0 0 0 0 0 6 2 2 2 7 0 0 0 0 0 0 
0 0 0 0 0 0 0 0 5 0 0 0 12 2 7 0 6 13 0 0 0 0 0 3 0 0 0 6 2 13 0 0 0 12 7 0 0 0 0 0 
0 0 0 0 0 0 0 0 5 0 0 0 0 0 12 2 13 0 0 0 0 0 10 9 0 0 6 13 0 0 0 0 0 0 12 7 0 0 0 0 
0 0 0 0 0 0 0 0 8 4 11 0 0 0 0 0 0 0 0 0 0 0 3 0 0 0 5 0 0 0 0 0 0 0 0 3 0 0 0 0 
0 0 0 0 0 0 0 0 0 0 5 0 0 0 0 0 0 0 0 0 0 0 3 1 6 2 13 0 0 0 0 0 0 0 0 12 7 0 0 0 
0 0 0 0 0 0 0 0 0 0 8 11 0 0 0 0 0 0 0 0 0 0 0 0 0 0 0 0 0 0 0 0 0 0 0 0 0 1 0 0 
0 0 0 0 0 0 0 0 0 0 0 5 0 0 0 0 0 0 0 0 0 0 0 0 0 0 0 0 0 0 0 0 0 0 0 0 0 1 0 0 
0 0 0 0 0 0 0 0 0 0 0 8 4 11 0 0 0 0 0 0 0 0 0 0 0 0 0 0 0 0 0 0 0 0 0 0 3 0 0 0 
0 0 0 0 0 0 0 0 0 0 0 0 0 8 4 11 0 0 0 0 0 0 0 0 0 0 0 0 0 0 0 0 0 0 0 10 9 0 0 0 
0 0 0 0 0 0 0 0 0 0 0 0 0 0 0 8 11 0 0 0 0 0 3 1 8 11 0 0 0 0 0 0 0 0 10 9 0 0 0 0 
0 0 0 0 0 0 0 0 0 0 0 0 0 0 0 0 8 11 0 0 0 0 3 0 0 8 4 11 0 0 0 0 10 4 9 0 0 0 0 0 
0 0 0 0 0 0 0 0 0 0 0 0 0 0 0 0 6 13 0 0 0 0 3 0 0 0 0 8 4 4 4 4 9 0 0 0 0 0 0 0 
0 0 0 0 0 0 0 0 0 0 0 0 0 0 0 6 13 0 0 0 0 0 12 7 0 0 0 0 0 0 0 0 0 0 0 0 0 0 0 0 
0 0 0 0 0 0 0 0 0 0 0 0 0 0 6 13 0 0 0 0 0 0 0 3 0 0 0 0 0 0 0 0 0 0 0 0 0 0 0 0 
0 0 0 0 0 0 0 0 0 0 0 0 0 0 5 0 0 0 0 0 0 0 0 12 7 0 0 0 0 0 0 0 0 0 0 0 0 0 0 0 
0 0 0 0 0 0 0 6 2 2 7 0 0 6 13 0 0 0 0 0 0 0 0 0 12 7 0 0 0 0 0 0 0 0 0 0 0 0 0 0 
0 0 0 0 0 6 2 13 0 0 12 7 0 5 0 0 0 0 0 0 0 0 0 0 0 3 0 0 0 0 0 0 0 0 0 0 0 0 0 0 
0 0 0 0 6 13 0 0 0 0 0 3 6 13 0 0 0 0 0 0 0 0 0 0 0 12 7 0 0 0 0 0 0 0 0 0 0 0 0 0 
0 0 0 0 5 0 0 0 0 0 0 12 13 0 10 4 11 0 0 0 0 0 0 0 0 0 12 7 0 0 0 0 0 0 0 0 0 0 0 0 
0 0 0 6 13 0 0 0 0 0 0 0 0 10 9 0 8 11 0 0 0 0 0 0 0 0 0 3 0 0 0 0 0 0 0 0 0 0 0 0 
0 0 0 5 0 0 0 0 0 0 0 0 0 3 0 0 0 8 4 11 0 0 0 0 0 0 10 9 0 0 0 0 0 0 0 0 0 0 0 0 
0 0 1 0 0 0 0 0 0 0 0 0 0 12 7 0 0 0 0 8 11 0 0 0 10 4 9 0 0 0 0 0 0 0 0 0 0 0 0 0 
0 0 1 0 0 0 0 0 0 0 0 0 0 0 3 0 0 0 0 0 8 11 0 0 12 7 0 0 0 0 0 0 0 0 0 0 0 0 0 0 
0 0 0 8 11 0 0 0 0 0 0 0 0 0 3 0 0 0 0 6 2 13 0 0 0 3 0 0 0 0 0 0 0 0 0 0 0 0 0 0 
0 0 0 0 8 11 0 0 0 0 0 0 10 4 9 0 0 0 0 5 0 0 0 0 0 12 7 0 0 0 0 0 0 0 0 0 0 0 0 0 
0 0 0 0 0 8 11 0 0 0 0 10 9 0 0 0 0 0 6 13 0 0 0 0 0 0 12 7 0 0 0 0 0 0 0 0 0 0 0 0 
0 0 0 0 0 0 8 4 11 0 0 3 0 0 0 0 0 6 13 0 0 0 0 0 0 0 0 12 7 0 0 0 0 0 0 0 0 0 0 0 
0 0 0 0 0 0 0 0 8 4 4 9 0 0 0 6 2 13 0 0 0 0 0 0 0 0 0 0 3 0 0 0 0 0 0 0 0 0 0 0 
0 0 0 0 0 0 0 0 0 0 0 0 0 0 0 5 0 0 0 0 0 0 0 0 0 0 0 0 12 2 7 0 0 0 0 0 0 0 0 0 
0 0 0 0 0 0 0 0 0 0 0 0 0 6 2 13 0 0 0 0 0 0 0 0 0 0 0 0 0 0 3 0 0 0 0 0 0 0 0 0 
0 0 0 0 0 0 0 0 0 0 0 0 0 5 0 0 0 0 0 0 0 0 0 0 0 0 0 10 4 4 9 0 0 0 0 0 0 0 0 0 
0 0 0 0 0 0 0 0 0 0 0 0 0 8 11 0 0 0 0 0 0 0 0 0 10 4 4 9 0 0 0 0 0 0 0 0 0 0 0 0 
0 0 0 0 0 0 0 0 0 0 0 0 0 0 5 0 0 0 0 0 0 0 0 10 9 0 0 0 0 0 0 0 0 0 0 0 0 0 0 0 
0 0 0 0 0 0 0 0 0 0 0 0 0 0 5 0 0 0 0 0 0 0 10 9 0 0 0 0 0 0 0 0 0 0 0 0 0 0 0 0 
0 0 0 0 0 0 0 0 0 0 0 0 0 0 5 0 0 0 0 0 0 0 3 0 0 0 0 0 0 0 0 0 0 0 0 0 0 0 0 0 
0 0 0 0 0 0 0 0 0 0 0 0 0 6 13 0 0 0 0 0 0 10 9 0 0 0 0 0 0 0 0 0 0 0 0 0 0 0 0 0 
0 0 0 0 0 0 0 0 0 0 0 0 0 5 0 0 0 0 0 0 0 3 0 0 0 0 0 0 0 0 0 0 0 0 0 0 0 0 0 0 
0 0 0 0 0 0 0 0 0 0 0 0 0 5 0 0 0 0 0 0 0 3 0 0 0 0 0 0 0 0 0 0 0 0 0 0 0 0 0 0 
0 0 0 0 0 0 0 0 0 0 0 0 0 8 11 0 0 0 0 0 10 9 0 0 0 0 0 0 0 0 0 0 0 0 0 0 0 0 0 0 
0 0 0 0 0 0 0 0 0 0 0 0 0 0 5 0 0 0 0 0 3 0 0 0 0 0 0 0 0 0 0 0 0 0 0 0 0 0 0 0 
0 0 0 0 0 0 0 0 0 0 0 0 0 0 8 11 0 0 0 10 9 0 0 0 0 0 0 0 0 0 0 0 0 0 0 0 0 0 0 0 
0 0 0 0 0 0 0 0 0 0 0 0 0 0 0 8 0 0 4 9 0 0 0 0 0 0 0 0 0 0 0 0 0 0 0 0 0 0 0 0 
0 0 0 0 0 0 0 0 0 0 0 0 0 0 0 0 1 1 0 0 0 0 0 0 0 0 0 0 0 0 0 0 0 0 0 0 0 0 0 0 
0 0 0 0 0 0 0 0 0 0 0 0 0 0 0 0 0 0 0 0 0 0 0 0 0 0 0 0 0 0 0 0 0 0 0 0 0 0 0 0 
0 0 0 0 0 0 0 0 0 0 0 0 0 0 0 0 0 0 0 0 0 0 0 0 0 0 0 0 0 0 0 0 0 0 0 0 0 0 0 0 
0 0 0 0 0 0 0 0 0 0 0 0 0 0 0 0 0 0 0 0 0 0 0 0 0 0 0 0 0 0 0 0 0 0 0 0 0 0 0 0 
