[TILESET]
CaveSheet

[TERRAIN]
0 0 0 0 0 0 0 0 0 0 0 0 0 0 0 0 0 0 0 0 0 0 0 0 0 0 0 0 0 0 0 0 0 0 0 0 0 0 0 0 
0 0 0 0 0 0 0 0 0 0 0 0 0 0 0 0 0 0 0 0 0 0 0 0 0 0 0 0 0 0 0 0 0 0 0 0 0 0 0 0 
0 0 0 0 0 0 0 0 0 0 0 0 0 0 0 0 0 0 0 0 0 0 0 0 0 0 0 0 0 0 0 0 0 0 0 0 0 0 0 0 
0 0 0 0 0 0 0 0 0 0 0 0 0 0 0 0 0 0 0 0 0 0 0 0 0 0 0 0 0 0 0 0 0 0 0 0 0 0 0 0 
0 0 0 0 0 0 0 0 0 0 0 0 0 0 0 0 0 8 4 16 20 4 9 0 0 0 0 0 0 0 0 0 0 0 0 0 0 0 0 0 
0 0 0 0 0 0 0 0 0 0 0 0 0 0 0 8 4 12 1 1 1 1 13 4 4 4 9 0 0 0 0 0 0 0 0 0 0 0 0 0 
0 0 0 0 0 0 0 0 0 0 0 0 0 0 0 5 2 1 2 3 3 3 1 1 2 1 13 4 9 0 0 0 0 0 0 0 0 0 0 0 
0 0 0 0 0 0 0 0 0 8 4 9 0 0 0 11 6 15 1 2 2 1 14 6 6 15 1 1 7 0 0 0 0 0 0 0 0 0 0 0 
0 0 0 0 0 0 0 0 8 12 1 13 4 9 0 0 0 11 15 1 1 14 10 0 0 11 15 2 13 9 0 0 0 0 0 0 0 0 0 0 
0 0 0 0 0 0 0 8 12 1 3 2 1 7 0 0 0 0 5 1 1 7 0 0 0 0 5 2 3 7 0 0 0 0 0 0 0 0 0 0 
0 0 0 0 0 0 0 5 1 3 3 2 1 7 0 0 0 0 5 1 1 7 0 0 0 0 5 2 3 13 9 8 9 0 0 0 0 0 0 0 
0 0 0 0 0 0 8 12 2 3 2 2 1 13 9 0 0 0 5 1 1 7 0 0 0 8 12 1 3 3 13 12 13 9 0 0 0 0 0 0 
0 0 0 0 0 0 5 1 2 1 14 15 1 1 7 0 0 8 12 1 1 13 9 0 8 12 1 1 1 1 1 1 1 7 0 0 0 0 0 0 
0 0 0 0 0 8 12 1 14 6 10 11 15 1 13 9 8 12 1 2 1 1 13 4 12 2 1 1 14 6 6 15 1 13 9 0 0 0 0 0 
0 0 0 0 0 5 1 14 10 0 0 0 11 15 2 13 12 2 2 2 2 2 1 1 1 2 1 14 10 0 0 11 15 1 7 0 0 0 0 0 
0 0 0 0 0 5 2 7 0 0 0 0 0 11 15 2 2 2 2 1 1 3 3 2 2 2 14 10 0 0 0 0 5 1 7 0 0 0 0 0 
0 0 0 0 0 5 1 7 0 0 0 0 0 0 11 6 15 1 3 3 3 3 3 1 1 1 7 0 0 0 0 0 5 1 7 0 0 0 0 0 
0 0 0 0 8 12 1 13 9 0 0 8 4 9 0 8 12 3 3 3 3 3 3 1 1 1 13 9 0 0 0 0 5 1 13 9 0 0 0 0 
0 0 0 0 5 2 2 1 13 4 4 12 3 13 4 12 3 3 3 3 3 1 1 1 1 14 6 10 0 0 0 0 5 1 2 7 0 0 0 0 
0 0 0 0 5 2 1 2 1 2 3 3 3 1 2 3 1 3 3 1 1 1 1 1 2 13 9 0 0 0 0 8 12 1 2 7 0 0 0 0 
0 0 0 0 5 1 2 2 2 1 3 3 2 2 2 3 1 3 3 3 3 1 1 1 1 2 13 9 0 0 0 5 1 2 2 7 0 0 0 0 
0 0 0 0 5 1 1 1 14 6 6 6 15 1 2 3 3 1 1 1 3 1 1 1 1 2 1 7 0 0 0 5 1 1 1 7 0 0 0 0 
0 0 0 0 11 15 1 14 10 0 0 0 11 15 2 1 3 1 3 3 3 1 1 2 2 2 14 10 0 0 0 11 15 1 14 10 0 0 0 0 
0 0 0 0 0 5 1 7 0 0 0 0 0 5 1 1 3 3 1 1 1 1 1 2 1 1 7 0 0 0 0 0 5 14 10 0 0 0 0 0 
0 0 0 0 0 5 2 7 0 0 0 0 0 11 15 1 2 3 3 3 1 1 1 2 1 1 13 9 0 0 0 0 5 7 0 0 0 0 0 0 
0 0 0 0 0 5 2 13 9 0 0 0 0 0 5 1 1 1 1 2 2 1 1 1 3 3 1 13 9 0 0 8 12 7 0 0 0 0 0 0 
0 0 0 0 0 11 15 1 13 4 4 9 0 0 11 6 6 15 1 2 1 1 14 6 15 3 3 3 13 4 4 12 1 7 0 0 0 0 0 0 
0 0 0 0 0 0 5 1 1 2 1 13 9 0 0 0 0 11 15 2 1 14 10 0 11 15 1 3 1 1 1 1 2 7 0 0 0 0 0 0 
0 0 0 0 0 0 11 15 1 1 1 2 13 9 0 0 0 0 5 1 1 7 0 0 0 11 15 3 3 1 2 1 14 10 0 0 0 0 0 0 
0 0 0 0 0 0 0 5 1 2 1 1 1 7 0 0 0 0 5 1 1 7 0 0 0 0 5 1 1 2 2 1 7 0 0 0 0 0 0 0 
0 0 0 0 0 0 0 11 15 2 2 2 1 7 0 0 0 0 5 1 2 7 0 0 0 0 5 1 2 2 1 14 10 0 0 0 0 0 0 0 
0 0 0 0 0 0 0 0 11 15 1 1 2 13 9 0 0 8 12 1 1 13 9 0 0 8 12 1 1 1 14 10 0 0 0 0 0 0 0 0 
0 0 0 0 0 0 0 0 0 11 6 15 1 1 13 4 4 12 1 2 2 1 13 9 0 11 6 15 14 6 10 0 0 0 0 0 0 0 0 0 
0 0 0 0 0 0 0 0 0 0 0 11 6 15 2 3 3 3 3 3 3 1 1 7 0 0 0 11 10 0 0 0 0 0 0 0 0 0 0 0 
0 0 0 0 0 0 0 0 0 0 0 0 0 11 6 6 6 15 2 2 2 1 14 10 0 0 0 0 0 0 0 0 0 0 0 0 0 0 0 0 
0 0 0 0 0 0 0 0 0 0 0 0 0 0 0 0 0 11 6 6 6 6 10 0 0 0 0 0 0 0 0 0 0 0 0 0 0 0 0 0 
0 0 0 0 0 0 0 0 0 0 0 0 0 0 0 0 0 0 0 0 0 0 0 0 0 0 0 0 0 0 0 0 0 0 0 0 0 0 0 0 
0 0 0 0 0 0 0 0 0 0 0 0 0 0 0 0 0 0 0 0 0 0 0 0 0 0 0 0 0 0 0 0 0 0 0 0 0 0 0 0 
0 0 0 0 0 0 0 0 0 0 0 0 0 0 0 0 0 0 0 0 0 0 0 0 0 0 0 0 0 0 0 0 0 0 0 0 0 0 0 0 
0 0 0 0 0 0 0 0 0 0 0 0 0 0 0 0 0 0 0 0 0 0 0 0 0 0 0 0 0 0 0 0 0 0 0 0 0 0 0 0 

[COLLISION]
0 0 0 0 0 0 0 0 0 0 0 0 0 0 0 0 0 0 0 0 0 0 0 0 0 0 0 0 0 0 0 0 0 0 0 0 0 0 0 0 
0 0 0 0 0 0 0 0 0 0 0 0 0 0 0 0 0 0 0 0 0 0 0 0 0 0 0 0 0 0 0 0 0 0 0 0 0 0 0 0 
0 0 0 0 0 0 0 0 0 0 0 0 0 0 0 0 0 0 0 0 0 0 0 0 0 0 0 0 0 0 0 0 0 0 0 0 0 0 0 0 
0 0 0 0 0 0 0 0 0 0 0 0 0 0 0 0 0 0 0 1 1 0 0 0 0 0 0 0 0 0 0 0 0 0 0 0 0 0 0 0 
0 0 0 0 0 0 0 0 0 0 0 0 0 0 0 0 0 6 2 0 0 2 7 0 0 0 0 0 0 0 0 0 0 0 0 0 0 0 0 0 
0 0 0 0 0 0 0 0 0 0 0 0 0 0 0 6 2 13 0 0 0 0 12 2 2 2 7 0 0 0 0 0 0 0 0 0 0 0 0 0 
0 0 0 0 0 0 0 0 0 0 0 0 0 0 0 5 0 0 0 0 0 0 0 0 0 0 12 2 7 0 0 0 0 0 0 0 0 0 0 0 
0 0 0 0 0 0 0 0 0 6 2 7 0 0 0 8 4 11 0 0 0 0 10 4 4 11 0 0 3 0 0 0 0 0 0 0 0 0 0 0 
0 0 0 0 0 0 0 0 6 13 0 12 2 7 0 0 0 8 11 0 0 10 9 0 0 8 11 0 12 7 0 0 0 0 0 0 0 0 0 0 
0 0 0 0 0 0 0 6 13 0 0 0 0 3 0 0 0 0 5 0 0 3 0 0 0 0 5 0 0 3 0 0 0 0 0 0 0 0 0 0 
0 0 0 0 0 0 0 5 0 0 0 0 0 3 0 0 0 0 5 0 0 3 0 0 0 0 5 0 0 12 7 6 7 0 0 0 0 0 0 0 
0 0 0 0 0 0 6 13 0 0 0 0 0 12 7 0 0 0 5 0 0 3 0 0 0 6 13 0 0 0 12 13 12 7 0 0 0 0 0 0 
0 0 0 0 0 0 5 0 0 0 10 11 0 0 3 0 0 6 13 0 0 12 7 0 6 13 0 0 0 0 0 0 0 3 0 0 0 0 0 0 
0 0 0 0 0 6 13 0 10 4 9 8 11 0 12 7 6 13 0 0 0 0 12 2 13 0 0 0 10 4 4 11 0 12 7 0 0 0 0 0 
0 0 0 0 0 5 0 10 9 0 0 0 8 11 0 12 13 0 0 0 0 0 0 0 0 0 0 10 9 0 0 8 11 0 3 0 0 0 0 0 
0 0 0 0 0 5 0 3 0 0 0 0 0 8 11 0 0 0 0 0 0 0 0 0 0 0 10 9 0 0 0 0 5 0 3 0 0 0 0 0 
0 0 0 0 0 5 0 3 0 0 0 0 0 0 8 4 11 0 0 0 0 0 0 0 0 0 3 0 0 0 0 0 5 0 3 0 0 0 0 0 
0 0 0 0 6 13 0 12 7 0 0 6 2 7 0 6 13 0 0 0 0 0 0 0 0 0 12 7 0 0 0 0 5 0 12 7 0 0 0 0 
0 0 0 0 5 0 0 0 12 2 2 13 0 12 2 13 0 0 0 0 0 0 0 0 0 10 4 9 0 0 0 0 5 0 0 3 0 0 0 0 
0 0 0 0 5 0 0 0 0 0 0 0 0 0 0 0 0 0 0 0 0 0 0 0 0 12 7 0 0 0 0 6 13 0 0 3 0 0 0 0 
0 0 0 0 5 0 0 0 0 0 0 0 0 0 0 0 0 0 0 0 0 0 0 0 0 0 12 7 0 0 0 5 0 0 0 3 0 0 0 0 
0 0 0 0 5 0 0 0 10 4 4 4 11 0 0 0 0 0 0 0 0 0 0 0 0 0 0 3 0 0 0 5 0 0 0 3 0 0 0 0 
0 0 0 0 8 11 0 10 9 0 0 0 8 11 0 0 0 0 0 0 0 0 0 0 0 0 10 9 0 0 0 8 11 0 10 9 0 0 0 0 
0 0 0 0 0 5 0 3 0 0 0 0 0 5 0 0 0 0 0 0 0 0 0 0 0 0 3 0 0 0 0 0 5 10 9 0 0 0 0 0 
0 0 0 0 0 5 0 3 0 0 0 0 0 8 11 0 0 0 0 0 0 0 0 0 0 0 12 7 0 0 0 0 5 3 0 0 0 0 0 0 
0 0 0 0 0 5 0 12 7 0 0 0 0 0 5 0 0 0 0 0 0 0 0 0 0 0 0 12 7 0 0 6 13 3 0 0 0 0 0 0 
0 0 0 0 0 8 11 0 12 2 2 7 0 0 8 4 4 11 0 0 0 0 10 4 11 0 0 0 12 2 2 13 0 3 0 0 0 0 0 0 
0 0 0 0 0 0 5 0 0 0 0 12 7 0 0 0 0 8 11 0 0 10 9 0 8 11 0 0 0 0 0 0 0 3 0 0 0 0 0 0 
0 0 0 0 0 0 8 11 0 0 0 0 12 7 0 0 0 0 5 0 0 3 0 0 0 8 11 0 0 0 0 0 10 9 0 0 0 0 0 0 
0 0 0 0 0 0 0 5 0 0 0 0 0 3 0 0 0 0 5 0 0 3 0 0 0 0 5 0 0 0 0 0 3 0 0 0 0 0 0 0 
0 0 0 0 0 0 0 8 11 0 0 0 0 3 0 0 0 0 5 0 0 3 0 0 0 0 5 0 0 0 0 10 9 0 0 0 0 0 0 0 
0 0 0 0 0 0 0 0 8 11 0 0 0 12 7 0 0 6 13 0 0 12 7 0 0 6 13 0 0 0 10 9 0 0 0 0 0 0 0 0 
0 0 0 0 0 0 0 0 0 8 4 11 0 0 12 2 2 13 0 0 0 0 12 7 0 8 4 11 10 4 9 0 0 0 0 0 0 0 0 0 
0 0 0 0 0 0 0 0 0 0 0 8 4 11 0 0 0 0 0 0 0 0 0 3 0 0 0 8 9 0 0 0 0 0 0 0 0 0 0 0 
0 0 0 0 0 0 0 0 0 0 0 0 0 8 4 4 4 11 0 0 0 0 10 9 0 0 0 0 0 0 0 0 0 0 0 0 0 0 0 0 
0 0 0 0 0 0 0 0 0 0 0 0 0 0 0 0 0 8 4 4 4 4 9 0 0 0 0 0 0 0 0 0 0 0 0 0 0 0 0 0 
0 0 0 0 0 0 0 0 0 0 0 0 0 0 0 0 0 0 0 0 0 0 0 0 0 0 0 0 0 0 0 0 0 0 0 0 0 0 0 0 
0 0 0 0 0 0 0 0 0 0 0 0 0 0 0 0 0 0 0 0 0 0 0 0 0 0 0 0 0 0 0 0 0 0 0 0 0 0 0 0 
0 0 0 0 0 0 0 0 0 0 0 0 0 0 0 0 0 0 0 0 0 0 0 0 0 0 0 0 0 0 0 0 0 0 0 0 0 0 0 0 
0 0 0 0 0 0 0 0 0 0 0 0 0 0 0 0 0 0 0 0 0 0 0 0 0 0 0 0 0 0 0 0 0 0 0 0 0 0 0 0 
