[TILESET]
CaveSheet

[TERRAIN]
0 0 0 0 0 0 0 0 0 0 0 0 0 0 0 0 0 0 0 0 0 0 0 0 0 0 0 0 0 0 0 0 0 0 0 0 0 0 0 0 
0 0 0 0 0 0 0 0 0 0 0 0 0 0 0 0 0 0 0 8 4 9 0 8 4 9 0 0 0 0 0 0 0 0 8 4 9 0 0 0 
0 0 0 0 8 4 9 0 0 0 0 0 0 8 4 9 0 8 4 12 2 7 0 5 2 13 4 9 0 8 4 4 4 4 12 1 7 0 0 0 
0 0 0 8 12 2 13 4 4 4 4 4 4 12 1 13 4 12 1 1 14 10 0 11 15 1 1 13 4 12 2 2 2 1 1 14 10 0 0 0 
0 0 0 11 15 1 1 1 2 1 1 1 1 2 2 2 2 2 1 14 10 0 0 0 5 1 2 2 2 2 2 1 1 1 14 10 0 0 0 0 
0 0 0 0 5 1 2 2 2 1 2 2 2 2 1 1 1 2 1 7 0 0 0 8 12 1 2 2 1 1 1 1 2 1 13 9 0 0 0 0 
0 0 0 0 5 1 2 2 1 1 2 1 1 1 1 1 2 2 1 7 0 0 8 12 1 2 1 1 2 1 1 2 2 1 1 13 9 0 0 0 
0 0 0 8 12 1 2 2 1 1 2 1 1 1 1 2 2 1 1 7 0 8 12 1 1 2 2 2 2 1 1 1 1 1 1 1 13 9 0 0 
0 0 0 5 1 1 2 2 1 1 2 1 1 1 2 2 1 1 14 10 0 11 6 15 1 1 1 1 2 1 1 1 1 1 1 2 1 7 0 0 
0 0 0 5 1 1 2 2 2 2 2 1 2 2 1 1 14 6 10 0 0 0 0 11 6 6 15 1 1 1 1 1 1 1 1 2 14 10 0 0 
0 0 0 11 6 15 2 2 1 2 2 1 2 1 1 14 10 0 0 8 9 0 0 0 0 0 11 15 1 1 1 1 1 1 2 2 7 0 0 0 
0 0 0 0 0 11 6 6 6 15 2 2 2 1 14 10 0 0 0 11 10 0 0 0 0 0 0 5 1 1 14 6 6 15 1 1 13 9 0 0 
0 0 0 0 0 0 0 0 0 11 15 1 1 2 13 4 4 4 9 0 0 0 0 0 8 4 4 12 1 1 13 9 0 11 6 15 14 10 0 0 
0 0 0 0 0 8 4 4 4 4 12 1 2 2 1 1 1 1 13 4 4 4 4 4 12 2 2 1 1 1 1 13 4 4 9 11 10 0 0 0 
0 0 0 8 4 12 2 2 1 2 2 2 2 1 2 2 2 2 2 1 2 2 1 1 1 2 2 2 2 2 2 1 1 1 13 9 0 0 0 0 
0 0 8 12 1 2 2 2 2 2 1 1 1 1 2 2 1 2 2 2 2 2 2 1 2 2 1 1 1 1 2 2 2 2 1 7 0 0 0 0 
0 0 5 1 2 2 1 1 1 1 1 1 14 15 1 2 1 1 1 2 2 1 2 2 2 1 1 1 1 2 2 2 2 2 2 13 9 0 0 0 
0 0 5 2 2 1 1 1 2 2 14 6 10 5 1 2 1 2 2 2 1 2 2 2 2 1 14 6 6 15 2 2 2 1 2 1 7 0 0 0 
0 0 23 2 2 1 1 2 2 2 13 9 8 12 1 2 1 1 1 1 2 2 1 2 2 1 13 9 0 5 1 2 2 2 2 1 7 0 0 0 
0 0 19 2 2 2 1 2 1 2 1 13 12 1 1 2 2 1 14 6 6 15 1 1 2 1 1 13 4 12 1 2 2 2 2 1 7 0 0 0 
0 0 5 1 1 2 2 2 2 2 1 1 1 1 2 2 1 1 13 9 0 11 15 1 2 1 1 1 1 2 2 1 1 1 2 1 7 0 0 0 
0 0 11 15 1 2 2 2 2 1 1 2 2 2 1 2 2 1 1 13 4 4 12 1 2 1 2 1 1 2 2 2 1 2 2 14 10 0 0 0 
0 0 0 5 1 2 2 2 2 2 2 2 1 2 1 1 2 2 2 2 1 1 2 2 2 2 2 2 2 2 1 2 2 2 2 7 0 0 0 0 
0 0 0 11 6 6 6 15 1 2 2 2 2 2 2 2 2 1 1 2 2 2 2 2 1 1 1 1 2 2 2 1 2 2 1 13 9 0 0 0 
0 0 0 0 0 0 0 11 15 2 2 1 14 6 6 6 6 6 15 1 2 2 1 1 14 6 6 15 1 2 2 2 14 6 15 14 10 0 0 0 
0 0 0 0 0 8 4 4 12 2 2 1 7 0 0 0 0 0 11 6 6 6 6 6 10 0 0 11 15 2 2 1 7 0 11 10 0 0 0 0 
0 0 0 8 4 12 1 1 1 2 1 14 10 8 9 0 0 0 0 0 0 0 0 0 0 8 9 0 5 1 1 1 13 9 0 0 0 0 0 0 
0 0 8 12 1 2 2 2 1 1 1 7 0 5 13 4 9 0 0 0 0 0 0 0 8 12 7 0 5 1 1 1 1 13 4 4 9 0 0 0 
0 0 5 1 2 2 1 2 2 2 1 7 0 11 15 1 13 4 4 4 4 4 9 0 11 6 10 8 12 1 1 2 2 2 1 1 13 9 0 0 
0 0 5 1 2 1 1 2 1 2 1 13 9 0 5 1 2 2 1 1 1 1 13 9 0 8 4 12 1 2 2 2 1 2 1 2 1 7 0 0 
0 0 5 1 2 2 2 2 2 2 1 1 7 0 5 2 2 2 1 2 2 2 1 13 4 12 1 1 2 2 1 1 2 2 2 2 1 7 0 0 
0 0 11 15 1 1 1 2 2 1 1 1 13 4 12 1 1 2 2 2 1 2 1 1 1 1 1 2 2 1 1 2 2 2 2 2 1 7 0 0 
0 0 0 11 15 1 1 2 2 2 2 2 1 1 1 1 2 2 2 1 2 2 1 1 2 1 1 1 1 1 1 2 1 2 1 2 1 7 0 0 
0 0 0 0 11 6 15 1 1 1 14 6 6 6 15 1 2 2 1 2 2 1 1 2 2 1 14 6 6 15 1 1 1 2 2 2 14 10 0 0 
0 8 4 9 0 0 11 6 6 6 10 0 0 0 11 15 1 1 1 2 1 1 2 2 1 14 10 0 0 11 6 15 1 1 2 14 10 0 0 0 
0 11 15 13 9 0 0 0 0 0 0 0 0 0 0 5 1 1 1 2 1 1 2 1 1 7 0 0 0 0 0 11 6 6 6 10 0 0 0 0 
0 0 11 15 13 4 4 9 0 0 0 0 0 0 0 11 15 1 1 2 2 2 2 1 1 7 0 0 0 0 0 0 0 0 0 0 0 0 0 0 
0 0 0 5 1 14 6 10 0 0 0 0 0 0 0 0 11 6 15 1 1 1 14 6 6 10 0 0 8 9 0 0 0 0 0 0 0 0 0 0 
0 0 0 5 2 7 0 0 0 0 0 0 0 0 0 0 0 0 11 6 6 6 10 0 0 0 0 8 12 13 4 4 9 0 0 0 0 0 0 0 
0 0 8 12 1 13 4 9 0 0 0 0 0 0 0 0 0 0 0 0 0 0 0 0 0 0 8 12 1 2 2 1 13 4 9 0 0 0 0 0 

[COLLISION]
0 0 0 0 0 0 0 0 0 0 0 0 0 0 0 0 0 0 0 0 0 0 0 0 0 0 0 0 0 0 0 0 0 0 0 0 0 0 0 0 
0 0 0 0 0 0 0 0 0 0 0 0 0 0 0 0 0 0 0 6 2 7 0 6 2 7 0 0 0 0 0 0 0 0 6 2 7 0 0 0 
0 0 0 0 6 2 7 0 0 0 0 0 0 6 2 7 0 6 2 13 0 3 0 5 0 12 2 7 0 6 2 2 2 2 13 0 3 0 0 0 
0 0 0 6 13 0 12 2 2 2 2 2 2 13 0 12 2 13 0 0 10 9 0 8 11 0 0 12 2 13 0 0 0 0 0 10 9 0 0 0 
0 0 0 8 11 0 0 0 0 0 0 0 0 0 0 0 0 0 0 10 9 0 0 0 5 0 0 0 0 0 0 0 0 0 10 9 0 0 0 0 
0 0 0 0 5 0 0 0 0 0 0 0 0 0 0 0 0 0 0 3 0 0 0 6 13 0 0 0 0 0 0 0 0 0 12 7 0 0 0 0 
0 0 0 0 5 0 0 0 0 0 0 0 0 0 0 0 0 0 0 3 0 0 6 13 0 0 0 0 0 0 0 0 0 0 0 12 7 0 0 0 
0 0 0 6 13 0 0 0 0 0 0 0 0 0 0 0 0 0 0 3 0 6 13 0 0 0 0 0 0 0 0 0 0 0 0 0 12 7 0 0 
0 0 0 5 0 0 0 0 0 0 0 0 0 0 0 0 0 0 10 9 0 8 4 11 0 0 0 0 0 0 0 0 0 0 0 0 0 3 0 0 
0 0 0 5 0 0 0 0 0 0 0 0 0 0 0 0 10 4 9 0 0 0 0 8 4 4 11 0 0 0 0 0 0 0 0 0 10 9 0 0 
0 0 0 8 4 11 0 0 0 0 0 0 0 0 0 10 9 0 0 0 0 0 0 0 0 0 8 11 0 0 0 0 0 0 0 0 3 0 0 0 
0 0 0 0 0 8 4 4 4 11 0 0 0 0 10 9 0 0 0 0 0 0 0 0 0 0 0 5 0 0 10 4 4 11 0 0 12 7 0 0 
0 0 0 0 0 0 0 0 0 8 11 0 0 0 12 2 2 2 7 0 0 0 0 0 6 2 2 13 0 0 12 7 0 8 4 11 10 9 0 0 
0 0 0 0 0 6 2 2 2 2 13 0 0 0 0 0 0 0 12 2 2 2 2 2 13 0 0 0 0 0 0 12 2 2 7 8 9 0 0 0 
0 0 0 6 2 13 0 0 0 0 0 0 0 0 0 0 0 0 0 0 0 0 0 0 0 0 0 0 0 0 0 0 0 0 12 7 0 0 0 0 
0 0 6 13 0 0 0 0 0 0 0 0 0 0 0 0 0 0 0 0 0 0 0 0 0 0 0 0 0 0 0 0 0 0 0 3 0 0 0 0 
0 0 5 0 0 0 0 0 0 0 0 0 10 11 0 0 0 0 0 0 0 0 0 0 0 0 0 0 0 0 0 0 0 0 0 12 7 0 0 0 
0 0 5 0 0 0 0 0 0 0 10 4 9 5 0 0 0 0 0 0 0 0 0 0 0 0 10 4 4 11 0 0 0 0 0 0 3 0 0 0 
0 1 0 0 0 0 0 0 0 0 0 7 6 13 0 0 0 0 0 0 0 0 0 0 0 0 12 7 0 5 0 0 0 0 0 0 3 0 0 0 
0 1 0 0 0 0 0 0 0 0 0 0 13 0 0 0 0 0 10 4 4 11 0 0 0 0 0 12 2 13 0 0 0 0 0 0 3 0 0 0 
0 0 5 0 0 0 0 0 0 0 0 0 0 0 0 0 0 0 12 7 0 8 11 0 0 0 0 0 0 0 0 0 0 0 0 0 3 0 0 0 
0 0 8 11 0 0 0 0 0 0 0 0 0 0 0 0 0 0 0 12 2 2 13 0 0 0 0 0 0 0 0 0 0 0 0 10 9 0 0 0 
0 0 0 5 0 0 0 0 0 0 0 0 0 0 0 0 0 0 0 0 0 0 0 0 0 0 0 0 0 0 0 0 0 0 0 3 0 0 0 0 
0 0 0 8 4 4 4 11 0 0 0 0 0 0 0 0 0 0 0 0 0 0 0 0 0 0 0 0 0 0 0 0 0 0 0 12 7 0 0 0 
0 0 0 0 0 0 0 8 11 0 0 0 10 4 4 4 4 4 11 0 0 0 0 0 10 4 4 11 0 0 0 0 10 4 11 10 9 0 0 0 
0 0 0 0 0 6 2 2 13 0 0 0 3 0 0 0 0 0 8 4 4 4 4 4 9 0 0 8 11 0 0 0 3 0 8 9 0 0 0 0 
0 0 0 6 2 13 0 0 0 0 0 10 9 6 7 0 0 0 0 0 0 0 0 0 0 0 0 0 5 0 0 0 12 7 0 0 0 0 0 0 
0 0 6 13 0 0 0 0 0 0 0 3 0 5 12 2 7 0 0 0 0 0 0 0 0 0 0 0 5 0 0 0 0 12 2 2 7 0 0 0 
0 0 5 0 0 0 0 0 0 0 0 3 0 8 11 0 12 2 2 2 2 2 7 0 0 0 0 6 13 0 0 0 0 0 0 0 12 7 0 0 
0 0 5 0 0 0 0 0 0 0 0 12 7 0 5 0 0 0 0 0 0 0 12 7 0 6 2 13 0 0 0 0 0 0 0 0 0 3 0 0 
0 0 5 0 0 0 0 0 0 0 0 0 3 0 5 0 0 0 0 0 0 0 0 12 2 13 0 0 0 0 0 0 0 0 0 0 0 3 0 0 
0 0 8 11 0 0 0 0 0 0 0 0 12 2 13 0 0 0 0 0 0 0 0 0 0 0 0 0 0 0 0 0 0 0 0 0 0 3 0 0 
0 0 0 8 11 0 0 0 0 0 0 0 0 0 0 0 0 0 0 0 0 0 0 0 0 0 0 0 0 0 0 0 0 0 0 0 0 3 0 0 
0 0 0 0 8 4 11 0 0 0 10 4 4 4 11 0 0 0 0 0 0 0 0 0 0 0 10 4 4 11 0 0 0 0 0 0 10 9 0 0 
0 0 0 0 0 0 8 4 4 4 9 0 0 0 8 11 0 0 0 0 0 0 0 0 0 10 9 0 0 8 4 11 0 0 0 10 9 0 0 0 
0 0 0 0 0 0 0 0 0 0 0 0 0 0 0 5 0 0 0 0 0 0 0 0 0 3 0 0 0 0 0 8 4 4 4 9 0 0 0 0 
0 0 0 0 0 0 0 0 0 0 0 0 0 0 0 8 11 0 0 0 0 0 0 0 0 3 0 0 0 0 0 0 0 0 0 0 0 0 0 0 
0 0 0 0 0 0 0 0 0 0 0 0 0 0 0 0 8 4 11 0 0 0 10 4 4 9 0 0 0 0 0 0 0 0 0 0 0 0 0 0 
0 0 0 0 0 0 0 0 0 0 0 0 0 0 0 0 0 0 8 4 4 4 9 0 0 0 0 0 0 0 0 0 0 0 0 0 0 0 0 0 
0 0 0 0 0 0 0 0 0 0 0 0 0 0 0 0 0 0 0 0 0 0 0 0 0 0 0 0 0 0 0 0 0 0 0 0 0 0 0 0 
