[TILESET]
CaveSheet

[TERRAIN]
0 0 0 0 0 0 0 0 0 0 0 0 0 0 0 0 0 0 0 0 
0 0 0 0 0 0 0 8 4 4 4 4 9 0 0 0 0 0 0 0 
0 0 0 0 0 0 8 12 1 2 2 2 13 4 4 9 0 0 0 0 
0 0 0 0 8 4 12 1 2 2 1 1 2 2 2 13 9 0 0 0 
0 0 0 8 12 2 2 2 2 30 25 25 28 1 2 2 13 9 0 0 
0 0 0 5 2 2 1 30 25 32 37 37 34 25 28 2 1 7 0 0 
0 0 0 5 2 1 30 32 37 37 37 37 37 37 24 2 2 7 0 0 
0 0 8 12 2 30 32 37 37 37 37 37 37 37 34 28 2 13 9 0 
0 8 12 2 2 26 37 37 37 37 37 37 37 37 37 24 2 2 7 0 
0 5 1 2 1 26 37 37 37 37 37 37 37 37 35 29 2 1 7 0 
0 11 15 2 1 31 33 37 37 37 37 37 37 37 24 2 2 1 7 0 
0 0 5 1 2 2 31 33 37 37 37 37 37 35 29 2 1 14 10 0 
0 0 5 1 1 2 1 31 33 37 37 37 35 29 2 2 1 7 0 0 
0 0 11 15 1 2 1 1 31 27 27 27 29 2 2 1 14 10 0 0 
0 0 0 11 15 2 2 2 2 2 2 1 2 2 1 14 10 0 0 0 
0 0 0 0 11 15 1 1 1 1 2 2 2 1 14 10 0 0 0 0 
0 0 0 0 0 11 6 6 15 1 1 14 6 6 10 0 0 0 0 0 
0 0 0 0 0 0 0 0 11 22 18 10 0 0 0 0 0 0 0 0 
0 0 0 0 0 0 0 0 0 0 0 0 0 0 0 0 0 0 0 0 
0 0 0 0 0 0 0 0 0 0 0 0 0 0 0 0 0 0 0 0 

[COLLISION]
0 0 0 0 0 0 0 0 0 0 0 0 0 0 0 0 0 0 0 0 
0 0 0 0 0 0 0 6 2 2 2 2 7 0 0 0 0 0 0 0 
0 0 0 0 0 0 6 13 0 0 0 0 12 2 2 7 0 0 0 0 
0 0 0 0 6 2 13 0 0 0 0 0 0 0 0 12 7 0 0 0 
0 0 0 6 13 0 0 0 0 10 4 4 11 0 0 0 12 7 0 0 
0 0 0 5 0 0 0 10 4 9 0 0 8 4 11 0 0 3 0 0 
0 0 0 5 0 0 10 9 0 0 0 0 0 0 5 0 0 3 0 0 
0 0 6 13 0 10 9 0 0 0 0 0 0 0 8 11 0 12 7 0 
0 6 13 0 0 3 0 0 0 0 0 0 0 0 0 5 0 0 3 0 
0 5 0 0 0 3 0 0 0 0 0 0 0 0 6 13 0 0 3 0 
0 8 11 0 0 12 7 0 0 0 0 0 0 0 5 0 0 0 3 0 
0 0 5 0 0 0 12 7 0 0 0 0 0 6 13 0 0 10 9 0 
0 0 5 0 0 0 0 12 7 0 0 0 6 13 0 0 0 3 0 0 
0 0 8 11 0 0 0 0 12 2 2 2 13 0 0 0 10 9 0 0 
0 0 0 8 11 0 0 0 0 0 0 0 0 0 0 10 9 0 0 0 
0 0 0 0 8 11 0 0 0 0 0 0 0 0 10 9 0 0 0 0 
0 0 0 0 0 8 4 4 11 0 0 10 4 4 9 0 0 0 0 0 
0 0 0 0 0 0 0 0 8 0 0 9 0 0 0 0 0 0 0 0 
0 0 0 0 0 0 0 0 0 0 0 0 0 0 0 0 0 0 0 0 
0 0 0 0 0 0 0 0 0 0 0 0 0 0 0 0 0 0 0 0 
