[TILESET]
SnowSheet

[TERRAIN]
65 65 65 65 65 65 65 65 65 65 65 65 65 65 65 65 65 65 65 65 65 72 27 31 2 2 2 2 2 2 2 2 18 1 1 1 1 75 65 65 65 65 64 64 64 64 65 65 65 65 65 65 65 65 65 65 65 65 65 65 
65 65 65 65 65 65 65 65 65 65 65 65 65 65 65 65 65 65 65 65 65 74 66 27 31 2 2 2 2 2 2 2 30 24 1 1 1 73 65 65 64 72 69 69 69 69 73 65 65 65 65 65 65 65 65 65 65 65 65 65 
65 65 65 65 65 65 65 65 65 64 64 64 64 64 64 65 65 65 65 65 65 65 65 74 27 31 2 2 2 2 2 2 2 30 16 16 24 71 73 72 69 70 1 1 1 1 71 73 64 65 65 65 65 65 65 65 65 65 65 65 
65 65 65 65 65 65 65 64 72 69 69 69 69 69 69 73 65 65 65 65 65 65 65 65 74 19 2 2 2 2 2 2 2 29 31 2 30 24 71 70 1 1 1 1 1 1 1 71 69 73 64 64 65 65 65 65 65 65 65 65 
65 65 65 65 65 64 72 69 70 9 6 6 6 8 1 71 73 65 65 65 65 65 65 65 72 19 2 2 2 2 2 2 2 18 27 31 2 30 16 16 16 24 1 1 1 1 1 1 1 71 69 69 73 64 65 65 65 65 65 65 
65 65 65 65 67 69 70 9 6 14 3 3 3 15 8 1 71 73 65 65 65 65 65 67 70 19 2 2 2 2 2 2 2 30 24 27 31 29 31 2 29 26 91 90 1 1 1 1 1 1 1 1 71 69 73 65 65 65 65 65 
64 64 65 65 72 1 9 14 3 13 4 4 12 3 15 8 1 71 68 65 65 65 65 67 25 28 2 2 2 2 2 2 2 2 30 16 28 30 28 29 26 82 84 83 1 1 1 1 75 74 1 1 1 1 71 73 65 65 65 65 
69 69 73 72 70 9 14 3 13 10 75 74 11 12 3 5 1 1 68 65 65 65 65 67 19 2 2 2 2 2 2 2 2 2 2 2 29 17 17 26 91 81 81 83 1 1 1 1 68 65 74 1 1 1 1 71 68 65 65 65 
6 8 71 70 9 14 3 13 10 75 65 65 74 7 3 5 1 1 68 65 65 65 65 72 27 31 2 2 2 2 2 2 2 29 31 2 18 91 90 91 81 81 81 88 1 1 1 1 68 65 65 74 1 1 1 1 68 65 65 65 
3 15 6 6 14 3 3 5 1 73 64 64 72 7 3 5 1 1 68 65 65 65 67 70 25 28 2 2 2 2 2 2 2 30 28 29 26 89 80 80 81 81 88 70 1 1 1 75 65 65 65 65 74 1 1 1 68 65 65 65 
4 4 4 4 4 4 12 15 8 71 69 69 70 7 3 5 1 1 68 65 65 65 65 74 19 2 2 2 2 29 17 17 17 17 17 26 1 71 69 69 89 88 70 1 1 1 1 68 65 65 65 65 72 1 1 1 68 65 65 65 
74 66 75 74 1 1 11 12 15 6 6 8 9 14 13 10 1 1 68 65 65 65 65 67 27 17 17 17 17 26 9 8 1 1 9 8 1 1 1 1 71 70 1 1 1 1 75 65 65 65 65 72 70 1 1 75 65 65 65 65 
65 65 65 65 74 1 1 7 3 3 3 15 14 3 15 8 1 1 68 65 65 65 65 65 74 66 1 1 1 9 14 15 8 1 11 10 9 6 6 8 1 1 1 1 66 75 65 65 65 65 65 74 1 1 1 73 65 65 65 65 
65 65 65 65 67 66 1 11 4 4 4 12 3 3 3 5 1 75 65 65 65 65 65 65 65 65 74 66 1 11 12 3 15 6 6 6 14 3 13 10 1 1 66 75 65 65 65 65 65 65 65 67 1 1 1 71 68 65 65 65 
65 65 65 65 65 65 74 1 1 1 1 11 4 12 3 15 8 73 65 65 65 65 65 65 65 65 65 65 74 1 11 4 12 3 3 3 3 13 10 1 1 75 65 65 65 65 65 65 65 65 65 67 1 1 1 1 68 65 65 65 
65 65 65 65 65 65 65 74 66 66 66 66 1 11 12 3 5 71 73 65 65 65 65 65 65 65 65 65 65 74 1 1 11 12 3 3 13 10 1 1 75 65 65 65 65 65 65 65 65 65 65 65 74 1 1 1 68 65 65 65 
65 65 65 65 65 65 65 65 65 65 65 65 74 1 11 12 15 8 71 73 65 65 65 65 65 65 65 65 65 67 1 1 1 7 3 3 5 1 1 75 65 65 65 65 65 65 65 65 65 65 65 65 67 1 1 1 68 65 65 65 
65 65 65 65 65 65 65 65 65 65 64 64 72 1 1 7 3 15 8 71 73 64 65 65 65 65 65 65 65 65 74 1 1 7 3 13 10 1 75 65 65 65 65 65 64 64 64 65 65 65 65 65 67 1 1 1 68 65 65 65 
65 65 65 65 65 65 65 65 64 72 69 69 70 1 66 11 12 3 15 8 71 69 68 65 65 65 65 65 65 65 65 74 1 11 12 5 1 1 68 65 65 65 64 72 69 69 69 73 64 65 65 65 72 1 1 1 68 65 65 65 
65 65 65 65 65 65 65 67 69 70 1 75 74 75 67 1 11 12 3 15 6 8 73 65 65 65 65 72 73 65 65 67 66 1 7 5 1 1 68 65 65 67 69 70 1 1 1 71 69 68 65 72 70 1 1 1 68 65 65 65 
65 65 65 65 65 65 65 72 1 1 75 65 65 65 65 74 1 7 3 3 3 5 71 73 64 64 72 70 71 73 65 65 67 1 11 10 1 1 68 65 65 72 1 1 9 6 8 1 1 73 72 70 1 1 1 1 68 65 65 65 
65 65 65 65 65 65 72 70 1 75 65 65 65 65 65 65 74 11 12 3 13 10 1 71 69 69 70 1 1 75 65 65 72 1 1 1 1 75 65 65 67 70 1 1 7 3 15 8 1 71 70 1 1 1 66 75 65 65 65 65 
65 65 65 65 65 67 70 1 1 68 65 65 65 65 65 65 67 1 11 4 10 1 1 1 1 1 1 1 1 73 64 72 70 1 1 1 1 68 65 65 67 1 1 9 14 13 12 15 8 1 1 1 1 75 65 65 65 65 65 65 
65 65 65 65 65 72 1 1 1 68 65 65 65 65 65 65 67 1 1 1 1 1 1 1 1 1 1 1 1 71 69 70 1 1 1 1 1 68 65 65 67 1 9 14 13 10 7 3 5 1 1 66 75 65 65 65 65 65 65 65 
65 65 65 65 67 70 1 1 1 68 65 65 65 65 65 65 72 1 1 1 1 1 1 1 66 1 1 1 1 1 1 1 1 1 1 1 1 68 65 65 72 1 11 12 15 6 14 13 10 1 75 65 65 65 65 65 65 65 65 65 
65 65 65 65 67 1 1 1 75 65 65 65 65 65 65 67 70 1 1 1 1 1 1 75 65 74 66 66 66 66 1 1 1 1 1 1 75 65 65 67 70 1 1 7 3 3 13 10 1 1 68 65 65 65 65 65 65 65 65 65 
65 65 65 65 65 74 1 1 73 65 65 65 65 65 65 72 1 1 1 1 1 1 1 68 65 65 65 65 65 65 74 1 1 1 1 66 68 65 65 67 1 1 1 11 4 4 10 1 1 1 73 65 65 65 65 65 65 65 65 65 
65 65 65 65 65 67 1 1 1 68 65 65 65 65 67 70 1 1 1 1 1 1 1 68 65 65 65 65 65 65 67 1 1 1 75 65 65 65 65 67 1 1 1 1 1 1 66 1 1 1 71 73 65 65 65 65 65 65 65 65 
65 65 65 65 65 65 74 1 1 73 65 65 65 65 67 1 1 1 1 1 1 1 1 68 65 65 65 65 65 65 67 1 1 1 68 65 65 65 65 65 74 66 66 66 66 75 65 74 1 1 1 71 68 65 65 65 65 65 65 65 
65 65 65 65 65 65 65 74 1 1 73 64 65 65 65 74 1 1 1 1 1 1 75 65 65 65 65 65 65 65 67 1 1 1 73 65 65 65 65 65 65 65 65 65 65 65 65 65 74 1 1 1 68 65 65 65 65 65 65 65 
65 65 65 65 65 65 65 67 66 66 71 69 73 64 64 72 1 1 1 1 1 1 73 65 65 65 65 65 65 65 67 1 1 1 71 73 64 65 65 65 65 65 65 65 65 65 65 65 72 1 1 1 68 65 65 65 65 65 65 65 
65 65 65 65 65 65 65 65 65 65 74 1 71 69 69 70 1 1 1 1 1 1 71 73 64 64 65 65 65 64 72 1 1 1 1 71 69 73 65 65 65 65 65 65 65 65 64 72 70 1 1 1 68 65 65 65 65 65 65 65 
65 65 65 65 65 65 65 65 65 65 65 74 66 66 66 1 1 1 1 1 1 1 1 71 69 69 73 64 72 69 70 1 1 1 1 1 1 71 73 64 64 65 65 65 65 72 69 70 1 1 1 1 68 65 65 65 65 65 65 65 
65 65 65 65 65 65 65 65 65 65 65 65 65 65 65 74 66 66 1 1 1 1 1 1 1 1 71 69 70 1 1 1 1 1 1 1 1 1 71 69 69 73 64 64 72 70 1 1 1 1 1 75 65 65 65 65 65 65 65 65 
65 65 65 65 65 65 65 65 65 65 65 65 65 65 65 65 65 65 74 66 66 66 66 66 1 1 1 1 1 1 1 1 1 66 75 74 66 1 1 1 1 71 69 69 70 1 1 1 1 66 75 65 65 65 65 65 65 65 65 65 
65 65 65 65 65 65 65 65 65 65 65 65 65 65 65 65 65 65 65 65 65 65 65 65 74 66 66 1 1 1 1 1 75 65 65 65 65 74 66 66 66 66 66 66 66 66 66 66 75 65 65 65 65 65 65 65 65 65 65 65 
65 65 65 65 65 65 65 65 65 65 65 65 65 65 65 65 65 65 65 65 65 65 65 65 65 65 65 74 66 66 66 75 65 65 65 65 65 65 65 65 65 65 65 65 65 65 65 65 65 65 65 65 65 65 65 65 65 65 65 65 
65 65 65 65 65 65 65 65 65 65 65 65 65 65 65 65 65 65 65 65 65 65 65 65 65 65 65 65 65 65 65 65 65 65 65 65 65 65 65 65 65 65 65 65 65 65 65 65 65 65 65 65 65 65 65 65 65 65 65 65 
65 65 65 65 65 65 65 65 65 65 65 65 65 65 65 65 65 65 65 65 65 65 65 65 65 65 65 65 65 65 65 65 65 65 65 65 65 65 65 65 65 65 65 65 65 65 65 65 65 65 65 65 65 65 65 65 65 65 65 65 
65 65 65 65 65 65 65 65 65 65 65 65 65 65 65 65 65 65 65 65 65 65 65 65 65 65 65 65 65 65 65 65 65 65 65 65 65 65 65 65 65 65 65 65 65 65 65 65 65 65 65 65 65 65 65 65 65 65 65 65 

[COLLISION]
0 0 0 0 0 0 0 0 0 0 0 0 0 0 0 0 0 0 0 0 0 0 0 0 0 0 0 0 0 0 0 0 0 0 0 0 0 0 0 0 0 0 1 1 1 1 0 0 0 0 0 0 0 0 0 0 0 0 0 0 
0 0 0 0 0 0 0 0 0 0 0 0 0 0 0 0 0 0 0 0 0 0 0 0 0 0 0 0 0 0 0 0 0 0 0 0 0 1 0 0 1 6 0 0 0 0 7 0 0 0 0 0 0 0 0 0 0 0 0 0 
0 0 0 0 0 0 0 0 0 1 1 1 1 1 1 0 0 0 0 0 0 0 0 0 0 0 0 0 0 0 0 0 0 0 0 0 6 0 7 6 0 0 0 0 0 0 0 7 1 0 0 0 0 0 0 0 0 0 0 0 
0 0 0 0 0 0 0 1 6 0 0 0 0 0 0 7 0 0 0 0 0 0 0 0 0 0 0 0 0 0 0 0 0 0 0 0 8 11 0 0 0 0 0 0 0 0 0 0 0 7 1 1 0 0 0 0 0 0 0 0 
0 0 0 0 0 1 6 0 0 0 0 0 0 0 0 0 7 0 0 0 0 0 0 0 0 0 0 0 0 0 0 0 0 0 0 0 0 8 4 4 4 11 0 0 0 0 0 0 0 0 0 0 7 1 0 0 0 0 0 0 
0 0 0 0 1 0 0 0 0 0 0 0 0 0 0 0 0 7 0 0 0 0 0 0 0 0 0 0 0 0 0 0 0 0 0 0 0 0 0 0 0 8 9 8 0 0 0 0 0 0 0 0 0 0 7 0 0 0 0 0 
1 1 0 0 6 0 0 0 0 0 0 0 0 0 0 0 0 0 1 0 0 0 0 0 0 0 0 0 0 0 0 0 0 0 0 0 0 0 0 0 0 0 0 1 0 0 0 0 9 8 0 0 0 0 0 7 0 0 0 0 
0 0 7 6 0 0 0 0 0 0 9 8 0 0 0 0 0 0 1 0 0 0 0 0 0 0 0 0 0 0 0 0 0 0 0 0 0 0 0 0 0 0 0 1 0 0 0 0 1 0 8 0 0 0 0 0 1 0 0 0 
0 0 0 0 0 0 0 0 0 9 0 0 8 0 0 0 0 0 1 0 0 0 0 0 0 0 0 0 0 0 0 0 0 0 0 0 0 0 0 0 0 0 0 6 0 0 0 0 1 0 0 8 0 0 0 0 1 0 0 0 
0 0 0 0 0 0 0 0 0 7 1 1 6 0 0 0 0 0 1 0 0 0 0 0 0 0 0 0 0 0 0 0 0 0 0 6 2 7 1 1 0 0 6 0 0 0 0 9 0 0 0 0 8 0 0 0 1 0 0 0 
0 0 0 0 0 0 0 0 0 0 0 0 0 0 0 0 0 0 1 0 0 0 0 0 0 0 0 0 0 6 2 2 2 2 2 13 0 0 0 0 7 6 0 0 0 0 0 1 0 0 0 0 6 0 0 0 1 0 0 0 
8 4 9 8 0 0 0 0 0 0 0 0 0 0 0 0 0 0 1 0 0 0 0 0 6 2 2 2 2 13 0 0 0 0 0 0 0 0 0 0 0 0 0 0 0 0 9 0 0 0 0 6 0 0 0 9 0 0 0 0 
0 0 0 0 8 0 0 0 0 0 0 0 0 0 0 0 0 0 1 0 0 0 0 0 8 4 0 0 0 0 0 0 0 0 0 0 0 0 0 0 0 0 0 0 4 9 0 0 0 0 0 8 0 0 0 7 0 0 0 0 
0 0 0 0 1 4 0 0 0 0 0 0 0 0 0 0 0 9 0 0 0 0 0 0 0 0 8 4 0 0 0 0 0 0 0 0 0 0 0 0 0 0 4 9 0 0 0 0 0 0 0 1 0 0 0 0 1 0 0 0 
0 0 0 0 0 0 8 0 0 0 0 0 0 0 0 0 0 7 0 0 0 0 0 0 0 0 0 0 8 0 0 0 0 0 0 0 0 0 0 0 0 9 0 0 0 0 0 0 0 0 0 1 0 0 0 0 1 0 0 0 
0 0 0 0 0 0 0 8 4 4 4 4 0 0 0 0 0 0 7 0 0 0 0 0 0 0 0 0 0 8 0 0 0 0 0 0 0 0 0 0 9 0 0 0 0 0 0 0 0 0 0 0 8 0 0 0 1 0 0 0 
0 0 0 0 0 0 0 0 0 0 0 0 8 0 0 0 0 0 0 7 0 0 0 0 0 0 0 0 0 1 0 0 0 0 0 0 0 0 0 9 0 0 0 0 0 0 0 0 0 0 0 0 1 0 0 0 1 0 0 0 
0 0 0 0 0 0 0 0 0 0 1 1 6 0 0 0 0 0 0 0 7 1 0 0 0 0 0 0 0 0 8 0 0 0 0 0 0 0 9 0 0 0 0 0 1 1 1 0 0 0 0 0 1 0 0 0 1 0 0 0 
0 0 0 0 0 0 0 0 1 6 0 0 0 0 4 0 0 0 0 0 0 0 1 0 0 0 0 0 0 0 0 8 0 0 0 0 0 0 1 0 0 0 1 6 0 0 0 7 1 0 0 0 6 0 0 0 1 0 0 0 
0 0 0 0 0 0 0 1 0 0 0 9 8 9 1 0 0 0 0 0 0 0 7 0 0 0 0 6 7 0 0 1 4 0 0 0 0 0 1 0 0 1 0 0 0 0 0 0 0 1 0 6 0 0 0 0 1 0 0 0 
0 0 0 0 0 0 0 6 0 0 9 0 0 0 0 8 0 0 0 0 0 0 0 7 1 1 6 0 0 7 0 0 1 0 0 0 0 0 1 0 0 6 0 0 0 0 0 0 0 7 6 0 0 0 0 0 1 0 0 0 
0 0 0 0 0 0 6 0 0 9 0 0 0 0 0 0 8 0 0 0 0 0 0 0 0 0 0 0 0 9 0 0 6 0 0 0 0 9 0 0 1 0 0 0 0 0 0 0 0 0 0 0 0 0 4 9 0 0 0 0 
0 0 0 0 0 1 0 0 0 1 0 0 0 0 0 0 1 0 0 0 0 0 0 0 0 0 0 0 0 7 1 6 0 0 0 0 0 1 0 0 1 0 0 0 0 0 0 0 0 0 0 0 0 9 0 0 0 0 0 0 
0 0 0 0 0 6 0 0 0 1 0 0 0 0 0 0 1 0 0 0 0 0 0 0 0 0 0 0 0 0 0 0 0 0 0 0 0 1 0 0 1 0 0 0 0 0 0 0 0 0 0 4 9 0 0 0 0 0 0 0 
0 0 0 0 1 0 0 0 0 1 0 0 0 0 0 0 6 0 0 0 0 0 0 0 4 0 0 0 0 0 0 0 0 0 0 0 0 1 0 0 6 0 0 0 0 0 0 0 0 0 9 0 0 0 0 0 0 0 0 0 
0 0 0 0 1 0 0 0 9 0 0 0 0 0 0 1 0 0 0 0 0 0 0 9 0 8 4 4 4 4 0 0 0 0 0 0 9 0 0 1 0 0 0 0 0 0 0 0 0 0 1 0 0 0 0 0 0 0 0 0 
0 0 0 0 0 8 0 0 7 0 0 0 0 0 0 6 0 0 0 0 0 0 0 1 0 0 0 0 0 0 8 0 0 0 0 4 1 0 0 1 0 0 0 0 0 0 0 0 0 0 7 0 0 0 0 0 0 0 0 0 
0 0 0 0 0 1 0 0 0 1 0 0 0 0 1 0 0 0 0 0 0 0 0 1 0 0 0 0 0 0 1 0 0 0 9 0 0 0 0 1 0 0 0 0 0 0 4 0 0 0 0 7 0 0 0 0 0 0 0 0 
0 0 0 0 0 0 8 0 0 7 0 0 0 0 1 0 0 0 0 0 0 0 0 1 0 0 0 0 0 0 1 0 0 0 1 0 0 0 0 0 8 4 4 4 4 9 0 8 0 0 0 0 1 0 0 0 0 0 0 0 
0 0 0 0 0 0 0 8 0 0 7 1 0 0 0 8 0 0 0 0 0 0 9 0 0 0 0 0 0 0 1 0 0 0 7 0 0 0 0 0 0 0 0 0 0 0 0 0 8 0 0 0 1 0 0 0 0 0 0 0 
0 0 0 0 0 0 0 1 4 4 0 0 7 1 1 6 0 0 0 0 0 0 7 0 0 0 0 0 0 0 1 0 0 0 0 7 1 0 0 0 0 0 0 0 0 0 0 0 6 0 0 0 1 0 0 0 0 0 0 0 
0 0 0 0 0 0 0 0 0 0 8 0 0 0 0 0 0 0 0 0 0 0 0 7 1 1 0 0 0 1 6 0 0 0 0 0 0 7 0 0 0 0 0 0 0 0 1 6 0 0 0 0 1 0 0 0 0 0 0 0 
0 0 0 0 0 0 0 0 0 0 0 8 4 4 4 0 0 0 0 0 0 0 0 0 0 0 7 1 6 0 0 0 0 0 0 0 0 0 7 1 1 0 0 0 0 6 0 0 0 0 0 0 1 0 0 0 0 0 0 0 
0 0 0 0 0 0 0 0 0 0 0 0 0 0 0 8 4 4 0 0 0 0 0 0 0 0 0 0 0 0 0 0 0 0 0 0 0 0 0 0 0 7 1 1 6 0 0 0 0 0 0 9 0 0 0 0 0 0 0 0 
0 0 0 0 0 0 0 0 0 0 0 0 0 0 0 0 0 0 8 4 4 4 4 4 0 0 0 0 0 0 0 0 0 4 9 8 4 0 0 0 0 0 0 0 0 0 0 0 0 4 9 0 0 0 0 0 0 0 0 0 
0 0 0 0 0 0 0 0 0 0 0 0 0 0 0 0 0 0 0 0 0 0 0 0 8 4 4 0 0 0 0 0 9 0 0 0 0 8 4 4 4 4 4 4 4 4 4 4 9 0 0 0 0 0 0 0 0 0 0 0 
0 0 0 0 0 0 0 0 0 0 0 0 0 0 0 0 0 0 0 0 0 0 0 0 0 0 0 8 4 4 4 9 0 0 0 0 0 0 0 0 0 0 0 0 0 0 0 0 0 0 0 0 0 0 0 0 0 0 0 0 
0 0 0 0 0 0 0 0 0 0 0 0 0 0 0 0 0 0 0 0 0 0 0 0 0 0 0 0 0 0 0 0 0 0 0 0 0 0 0 0 0 0 0 0 0 0 0 0 0 0 0 0 0 0 0 0 0 0 0 0 
0 0 0 0 0 0 0 0 0 0 0 0 0 0 0 0 0 0 0 0 0 0 0 0 0 0 0 0 0 0 0 0 0 0 0 0 0 0 0 0 0 0 0 0 0 0 0 0 0 0 0 0 0 0 0 0 0 0 0 0 
0 0 0 0 0 0 0 0 0 0 0 0 0 0 0 0 0 0 0 0 0 0 0 0 0 0 0 0 0 0 0 0 0 0 0 0 0 0 0 0 0 0 0 0 0 0 0 0 0 0 0 0 0 0 0 0 0 0 0 0 
