[TILESET]
SnowSheet

[TERRAIN]
36 36 36 36 36 36 36 36 36 36 36 36 36 36 36 36 36 36 36 36 36 36 36 36 36 36 36 36 36 36 36 36 
36 36 36 36 36 36 36 36 36 36 36 36 36 36 36 36 36 36 36 36 36 36 36 36 36 36 36 36 36 36 36 36 
36 36 36 36 36 36 36 36 36 36 36 36 59 40 44 52 40 40 57 36 36 36 36 36 36 36 36 36 36 36 36 36 
36 36 36 36 36 36 36 36 36 36 36 59 50 1 1 1 1 1 51 40 40 57 36 36 36 36 36 36 36 36 36 36 
36 36 36 36 36 36 36 36 36 36 59 50 1 9 6 6 8 1 75 74 1 41 36 36 36 36 36 36 36 36 36 36 
36 36 36 36 36 36 36 36 36 36 43 1 9 14 3 3 5 1 73 72 1 41 36 36 36 36 36 36 36 36 36 36 
36 36 36 36 36 36 36 36 36 36 43 1 11 4 12 13 10 1 71 70 1 41 36 36 36 36 36 36 36 36 36 36 
36 36 36 36 36 36 36 36 36 36 56 48 1 1 11 10 1 1 49 42 42 58 36 36 36 36 36 36 36 36 36 36 
36 36 36 36 36 36 36 36 36 36 36 56 48 1 1 1 1 49 58 36 36 36 36 36 36 36 36 36 36 36 36 36 
36 36 36 36 36 36 36 36 36 36 36 36 33 1 1 1 49 58 36 36 36 36 36 36 36 36 36 36 36 36 36 36 
36 36 36 36 36 36 36 36 36 36 36 36 56 48 1 1 35 36 36 36 36 36 36 36 36 36 36 36 36 36 36 36 
36 36 36 36 36 36 36 36 36 36 36 36 36 33 1 1 35 36 36 36 36 36 36 36 36 36 36 36 36 36 36 36 
36 36 36 36 36 36 36 36 36 36 36 36 36 33 1 1 51 57 36 36 36 36 36 36 36 36 36 36 36 36 36 36 
36 36 36 36 36 36 36 36 36 36 36 36 36 33 1 1 1 35 36 36 36 36 36 36 36 36 36 36 36 36 36 36 
36 36 36 36 36 36 36 36 36 36 36 36 36 33 1 1 1 35 36 36 36 36 36 36 36 36 36 36 36 36 36 36 
36 36 36 36 36 36 36 36 36 36 36 36 36 33 1 1 1 35 36 36 36 36 36 36 36 36 36 36 36 36 36 36 
36 36 36 36 36 36 36 36 36 36 36 36 36 56 48 1 1 51 57 36 36 36 36 36 36 36 36 36 36 36 36 36 
36 36 36 36 36 36 36 36 36 36 36 36 36 36 33 1 1 1 51 57 36 36 36 36 36 36 36 36 36 36 36 36 
36 36 36 36 36 36 36 36 36 36 36 36 36 36 56 48 1 1 1 51 57 36 36 36 36 36 36 36 36 36 36 36 
36 36 36 36 36 36 36 36 36 36 36 36 36 36 36 33 1 1 1 1 51 34 34 57 36 36 36 36 36 36 36 36 
36 36 36 36 36 36 36 36 36 36 36 36 36 36 36 56 42 48 1 1 1 1 1 51 34 57 36 36 36 36 36 36 
36 36 36 36 36 36 36 36 36 36 36 36 36 36 36 36 36 56 42 48 1 1 1 1 1 35 36 36 36 36 36 36 
36 36 36 36 36 36 36 36 36 36 36 36 36 36 36 36 36 36 36 56 48 1 1 1 1 51 57 36 36 36 36 36 
36 36 36 36 36 36 36 36 36 36 36 36 36 36 36 36 36 36 36 36 56 48 1 1 1 1 41 36 36 36 36 36 
36 36 36 36 36 36 36 36 36 36 36 36 36 36 36 36 36 36 36 36 59 50 1 1 1 1 41 36 36 36 36 36 
36 36 36 36 36 36 36 36 36 36 36 36 36 36 36 36 59 34 34 34 50 1 1 1 1 1 41 36 36 36 36 36 
36 36 36 36 36 36 36 36 36 36 36 59 34 34 34 34 50 1 1 1 1 1 1 1 1 49 58 36 36 36 36 36 
36 36 36 36 36 36 36 36 36 59 34 50 1 1 1 1 1 1 1 1 1 1 1 1 1 41 36 36 36 36 36 36 
36 36 36 36 36 36 59 34 34 50 1 1 1 1 1 1 1 1 1 1 1 1 1 49 42 58 36 36 36 36 36 36 
36 36 36 36 36 59 50 1 1 1 1 1 1 1 1 1 1 1 1 1 1 49 42 58 36 36 36 36 36 36 36 36 
36 36 36 36 36 33 1 1 1 1 1 1 1 66 66 75 74 49 42 42 42 58 36 36 36 36 36 36 36 36 36 36 
36 36 36 36 59 50 1 1 1 1 1 1 75 65 65 65 67 41 36 36 36 36 36 36 36 36 36 36 36 36 36 36 
36 36 36 36 33 1 1 1 1 1 1 75 65 65 65 65 67 41 36 36 36 36 36 36 36 36 36 36 36 36 36 36 
36 36 36 59 50 1 1 1 1 1 1 68 65 65 65 65 67 41 36 36 36 36 36 36 36 36 36 36 36 36 36 36 
36 36 36 43 66 75 74 1 1 1 1 73 65 65 65 64 72 41 36 36 36 36 36 36 36 36 36 36 36 36 36 36 
36 36 36 43 68 65 65 74 1 1 1 71 73 65 67 69 70 41 36 36 36 36 36 36 36 36 36 36 36 36 36 36 
36 36 36 43 68 65 65 65 74 1 1 1 71 73 72 49 42 58 36 36 36 36 36 36 36 36 36 36 36 36 36 36 
36 36 36 43 68 65 65 65 65 74 1 1 1 71 70 41 36 36 36 36 36 36 36 36 36 36 36 36 36 36 36 36 
36 36 59 50 68 65 65 65 64 72 1 1 1 1 49 58 36 36 36 36 36 36 36 36 36 36 36 36 36 36 36 36 
36 36 43 75 65 65 64 72 69 70 1 1 49 42 58 36 36 36 36 36 36 36 36 36 36 36 36 36 36 36 36 36 
36 36 43 68 65 72 69 70 1 1 1 1 41 36 36 36 36 36 36 36 36 36 36 36 36 36 36 36 36 36 36 36 
36 36 43 73 72 70 1 1 1 1 49 42 58 36 36 36 36 36 36 36 36 36 36 36 36 36 36 36 36 36 36 36 
36 36 43 71 70 1 1 1 49 42 58 36 36 36 36 36 36 36 36 36 36 36 36 36 36 36 36 36 36 36 36 36 
36 36 56 42 48 1 1 1 35 36 36 36 36 36 36 36 36 36 36 36 36 36 36 36 36 36 36 36 36 36 36 36 
36 36 36 36 56 48 1 1 51 57 36 36 36 36 36 36 36 36 36 36 36 36 36 36 36 36 36 36 36 36 36 36 
36 36 36 36 36 43 1 1 1 51 34 57 36 36 36 36 36 36 36 36 36 36 36 36 36 36 36 36 36 36 36 36 
36 36 36 36 36 56 48 1 1 1 1 51 34 34 34 34 34 34 57 36 36 36 36 36 36 36 36 36 36 36 36 36 
36 36 36 36 36 36 43 1 1 1 1 1 1 1 1 1 1 1 51 34 34 34 57 36 36 36 36 36 36 36 36 36 
36 36 36 36 36 36 56 42 42 42 48 1 1 1 1 1 1 1 1 1 1 1 51 34 57 36 36 36 36 36 36 36 
36 36 36 36 36 36 36 36 36 36 56 42 42 48 1 1 1 1 1 1 1 1 1 1 35 36 36 36 36 36 36 36 
36 36 36 36 36 36 36 36 36 36 36 36 36 33 1 1 1 75 74 75 74 1 1 1 51 57 36 36 36 36 36 36 
36 36 36 36 36 36 36 36 36 36 36 36 59 50 1 1 1 73 64 65 67 1 1 1 1 35 36 36 36 36 36 36 
36 36 36 36 36 36 36 36 36 36 36 59 50 1 1 1 1 71 69 73 65 74 1 1 1 51 57 36 36 36 36 36 
36 36 36 36 36 36 36 36 36 59 34 50 1 1 1 1 1 1 1 71 73 72 1 1 1 1 35 36 36 36 36 36 
36 36 36 36 36 36 36 36 59 50 1 1 1 1 1 1 1 1 1 1 71 70 1 1 1 1 35 36 36 36 36 36 
36 36 36 36 36 36 36 59 50 1 1 1 1 1 1 1 1 1 1 1 1 1 1 1 1 49 58 36 36 36 36 36 
36 36 36 36 36 59 34 50 1 1 1 1 1 1 1 1 49 42 42 42 48 1 1 49 42 58 36 36 36 36 36 36 
36 36 36 36 36 33 1 1 1 1 1 1 1 49 42 42 58 36 36 36 56 42 42 58 36 36 36 36 36 36 36 36 
36 36 36 36 36 33 1 1 1 1 1 49 42 58 36 36 36 36 36 36 36 36 36 36 36 36 36 36 36 36 36 36 
36 36 36 36 36 33 1 1 1 1 49 58 36 36 36 36 36 36 36 36 36 36 36 36 36 36 36 36 36 36 36 36 
36 36 36 36 59 50 1 1 1 49 58 36 36 36 36 36 36 36 36 36 36 36 36 36 36 36 36 36 36 36 36 36 
36 36 36 36 33 1 1 1 1 35 36 36 36 36 36 36 36 36 36 36 36 36 36 36 36 36 36 36 36 36 36 36 
36 36 36 36 33 1 1 1 1 35 36 36 36 36 36 36 36 36 36 36 36 36 36 36 36 36 36 36 36 36 36 36 
36 36 36 36 33 1 1 1 1 35 36 36 36 36 36 36 36 36 36 36 36 36 36 36 36 36 36 36 36 36 36 36 
36 36 36 36 33 1 9 8 1 51 57 36 36 36 36 36 36 36 36 36 36 36 36 36 36 36 36 36 36 36 36 36 
36 36 36 36 33 1 7 15 6 8 51 34 34 34 44 52 34 34 57 36 36 36 36 36 36 36 36 36 36 59 34 34 
36 36 36 36 56 48 11 12 3 15 6 6 8 1 1 1 9 8 51 34 34 34 34 57 36 36 36 59 34 50 75 74 
36 36 36 36 36 33 9 14 13 4 12 3 15 8 1 1 7 15 8 1 1 1 1 51 34 57 59 50 66 75 65 65 
36 36 36 36 36 33 11 12 15 6 14 3 13 10 1 1 11 4 10 1 1 1 1 1 1 41 43 75 65 65 65 65 
36 36 36 36 36 33 1 11 12 13 4 4 10 1 1 49 42 42 42 42 42 48 1 1 1 51 50 68 65 65 65 65 
36 36 36 36 36 56 48 1 11 10 1 1 1 49 42 58 36 36 36 36 36 56 42 48 1 1 1 68 65 65 65 65 
36 36 36 36 36 36 56 42 42 42 42 42 42 58 36 36 36 36 36 36 36 36 36 56 48 1 1 73 65 65 65 65 
36 36 36 36 36 36 36 36 36 36 36 36 36 36 36 36 36 36 36 36 36 36 36 36 33 1 1 71 68 65 65 65 
36 36 36 36 36 36 36 36 36 36 36 36 36 36 36 36 36 36 36 36 36 36 36 36 33 1 1 1 68 65 65 65 
34 34 57 36 36 36 36 36 36 36 36 36 36 36 36 36 36 36 36 36 36 36 36 36 56 48 1 1 68 65 65 65 
91 90 51 57 36 36 36 36 36 36 36 36 36 36 36 36 36 36 36 36 36 36 36 36 36 33 1 1 68 65 65 65 
81 81 90 51 34 57 36 36 36 36 36 36 36 36 36 36 36 36 36 36 36 36 36 36 59 50 1 1 68 65 65 65 
81 81 83 82 82 51 34 34 57 36 36 36 36 36 36 36 36 36 36 36 36 36 36 36 33 1 1 1 68 65 65 65 
81 81 81 81 81 90 91 90 35 36 36 36 36 59 34 34 34 34 57 36 36 36 36 59 50 1 1 1 68 65 65 65 
81 81 81 81 81 81 81 83 35 36 59 34 34 50 1 1 1 1 51 34 34 57 59 50 1 1 1 75 65 65 65 65 
81 81 81 81 81 81 81 88 35 59 50 1 1 1 1 1 1 1 1 1 1 51 50 1 1 1 1 68 65 65 65 65 
81 81 81 81 81 81 88 70 51 50 1 1 1 1 1 49 42 48 1 1 1 1 1 1 1 1 75 65 65 65 65 65 
81 81 81 81 80 88 70 1 1 1 1 1 1 49 42 58 36 56 42 42 42 42 42 42 42 48 73 64 64 65 65 65 
81 81 81 83 85 70 1 1 9 8 1 1 1 35 36 36 36 36 36 36 36 36 36 36 36 43 71 69 69 73 64 64 
81 81 81 83 1 1 1 9 14 15 8 1 1 51 57 36 36 36 36 36 36 36 36 36 36 56 42 42 48 71 69 69 
81 81 81 88 1 1 9 14 3 3 5 1 1 1 51 34 34 34 34 57 36 36 36 36 36 36 36 36 56 42 42 42 
81 81 83 70 1 9 14 3 13 12 15 6 8 1 1 1 1 91 90 35 36 36 36 36 36 36 36 36 36 36 36 36 
81 81 88 1 1 11 12 3 5 11 4 12 15 8 1 1 91 81 83 35 36 36 36 36 36 36 36 36 36 36 36 36 
81 83 70 1 1 1 11 12 15 8 9 14 13 10 1 1 84 81 83 35 36 36 36 36 36 36 36 36 36 36 36 36 
81 81 90 82 1 1 9 14 3 15 14 3 5 1 1 91 81 81 83 51 57 36 36 36 36 36 36 36 36 36 36 36 
81 81 81 81 90 1 11 12 3 3 3 13 10 1 82 84 81 81 81 90 51 57 36 36 36 36 36 36 36 36 36 36 
81 81 81 81 83 1 1 7 3 3 13 10 1 91 81 81 81 81 81 81 90 51 57 36 36 36 36 36 36 36 36 36 
81 81 81 81 81 90 1 7 13 4 10 1 1 84 81 81 81 81 81 81 81 90 51 57 36 36 36 36 36 36 36 36 
81 81 81 81 81 83 1 11 10 1 1 1 91 81 81 81 81 81 81 81 81 83 1 35 36 36 36 36 36 36 36 36 
81 81 81 81 81 81 90 1 1 1 1 1 84 81 81 81 81 81 81 81 81 81 90 51 57 36 36 36 36 36 36 36 
81 81 81 81 81 81 83 1 1 1 1 91 81 81 81 81 81 81 81 81 81 81 81 90 35 36 36 36 36 36 36 36 

[COLLISION]
0 0 0 0 0 0 0 0 0 0 0 0 0 0 0 0 0 0 0 0 0 0 0 0 0 0 0 0 0 0 0 0 
0 0 0 0 0 0 0 0 0 0 0 0 0 0 1 1 0 0 0 0 0 0 0 0 0 0 0 0 0 0 0 0 
0 0 0 0 0 0 0 0 0 0 0 0 6 2 0 0 2 2 7 0 0 0 0 0 0 0 0 0 0 0 0 0 
0 0 0 0 0 0 0 0 0 0 0 6 13 0 0 0 0 0 12 2 2 7 0 0 0 0 0 0 0 0 0 0 
0 0 0 0 0 0 0 0 0 0 6 13 0 0 0 0 0 0 9 8 0 3 0 0 0 0 0 0 0 0 0 0 
0 0 0 0 0 0 0 0 0 0 5 0 0 0 0 0 0 0 7 6 0 3 0 0 0 0 0 0 0 0 0 0 
0 0 0 0 0 0 0 0 0 0 5 0 0 0 0 0 0 0 0 0 0 3 0 0 0 0 0 0 0 0 0 0 
0 0 0 0 0 0 0 0 0 0 8 11 0 0 0 0 0 0 10 4 4 9 0 0 0 0 0 0 0 0 0 0 
0 0 0 0 0 0 0 0 0 0 0 8 11 0 0 0 0 10 9 0 0 0 0 0 0 0 0 0 0 0 0 0 
0 0 0 0 0 0 0 0 0 0 0 0 5 0 0 0 10 9 0 0 0 0 0 0 0 0 0 0 0 0 0 0 
0 0 0 0 0 0 0 0 0 0 0 0 8 11 0 0 3 0 0 0 0 0 0 0 0 0 0 0 0 0 0 0 
0 0 0 0 0 0 0 0 0 0 0 0 0 5 0 0 3 0 0 0 0 0 0 0 0 0 0 0 0 0 0 0 
0 0 0 0 0 0 0 0 0 0 0 0 0 5 0 0 12 7 0 0 0 0 0 0 0 0 0 0 0 0 0 0 
0 0 0 0 0 0 0 0 0 0 0 0 0 5 0 0 0 3 0 0 0 0 0 0 0 0 0 0 0 0 0 0 
0 0 0 0 0 0 0 0 0 0 0 0 0 5 0 0 0 3 0 0 0 0 0 0 0 0 0 0 0 0 0 0 
0 0 0 0 0 0 0 0 0 0 0 0 0 5 0 0 0 3 0 0 0 0 0 0 0 0 0 0 0 0 0 0 
0 0 0 0 0 0 0 0 0 0 0 0 0 8 11 0 0 12 7 0 0 0 0 0 0 0 0 0 0 0 0 0 
0 0 0 0 0 0 0 0 0 0 0 0 0 0 5 0 0 0 12 7 0 0 0 0 0 0 0 0 0 0 0 0 
0 0 0 0 0 0 0 0 0 0 0 0 0 0 8 11 0 0 0 12 7 0 0 0 0 0 0 0 0 0 0 0 
0 0 0 0 0 0 0 0 0 0 0 0 0 0 0 5 0 0 0 0 12 2 2 7 0 0 0 0 0 0 0 0 
0 0 0 0 0 0 0 0 0 0 0 0 0 0 0 8 4 11 0 0 0 0 0 12 2 7 0 0 0 0 0 0 
0 0 0 0 0 0 0 0 0 0 0 0 0 0 0 0 0 8 4 11 0 0 0 0 0 3 0 0 0 0 0 0 
0 0 0 0 0 0 0 0 0 0 0 0 0 0 0 0 0 0 0 8 11 0 0 0 0 12 7 0 0 0 0 0 
0 0 0 0 0 0 0 0 0 0 0 0 0 0 0 0 0 0 0 0 8 11 0 0 0 0 3 0 0 0 0 0 
0 0 0 0 0 0 0 0 0 0 0 0 0 0 0 0 0 0 0 0 6 13 0 0 0 0 3 0 0 0 0 0 
0 0 0 0 0 0 0 0 0 0 0 0 0 0 0 0 6 2 2 2 13 0 0 0 0 0 3 0 0 0 0 0 
0 0 0 0 0 0 0 0 0 0 0 6 2 2 2 2 13 0 0 0 0 0 0 0 0 10 9 0 0 0 0 0 
0 0 0 0 0 0 0 0 0 6 2 13 0 0 0 0 0 0 0 0 0 0 0 0 0 3 0 0 0 0 0 0 
0 0 0 0 0 0 6 2 2 13 0 0 0 0 0 0 0 0 0 0 0 0 0 10 4 9 0 0 0 0 0 0 
0 0 0 0 0 6 13 0 0 0 0 0 0 0 0 0 0 0 0 0 0 10 4 9 0 0 0 0 0 0 0 0 
0 0 0 0 0 5 0 0 0 0 0 0 0 4 4 9 8 4 4 4 4 9 0 0 0 0 0 0 0 0 0 0 
0 0 0 0 6 13 0 0 0 0 0 0 9 0 0 0 0 0 0 0 0 0 0 0 0 0 0 0 0 0 0 0 
0 0 0 0 5 0 0 0 0 0 0 9 0 0 0 0 0 0 0 0 0 0 0 0 0 0 0 0 0 0 0 0 
0 0 0 6 13 0 0 0 0 0 0 1 0 0 0 0 0 0 0 0 0 0 0 0 0 0 0 0 0 0 0 0 
0 0 0 8 4 9 8 0 0 0 0 7 0 0 0 0 0 0 0 0 0 0 0 0 0 0 0 0 0 0 0 0 
0 0 0 0 0 0 0 8 0 0 0 0 7 0 0 0 0 0 0 0 0 0 0 0 0 0 0 0 0 0 0 0 
0 0 0 0 0 0 0 0 8 0 0 0 0 7 6 7 0 0 0 0 0 0 0 0 0 0 0 0 0 0 0 0 
0 0 0 0 0 0 0 0 0 8 0 0 0 0 0 3 0 0 0 0 0 0 0 0 0 0 0 0 0 0 0 0 
0 0 0 0 0 0 0 0 1 6 0 0 0 0 10 9 0 0 0 0 0 0 0 0 0 0 0 0 0 0 0 0 
0 0 0 0 0 0 1 6 0 0 0 0 10 4 9 0 0 0 0 0 0 0 0 0 0 0 0 0 0 0 0 0 
0 0 0 0 0 6 0 0 0 0 0 0 3 0 0 0 0 0 0 0 0 0 0 0 0 0 0 0 0 0 0 0 
0 0 6 7 6 0 0 0 0 0 10 4 9 0 0 0 0 0 0 0 0 0 0 0 0 0 0 0 0 0 0 0 
0 0 5 0 0 0 0 0 10 4 9 0 0 0 0 0 0 0 0 0 0 0 0 0 0 0 0 0 0 0 0 0 
0 0 8 4 11 0 0 0 3 0 0 0 0 0 0 0 0 0 0 0 0 0 0 0 0 0 0 0 0 0 0 0 
0 0 0 0 8 11 0 0 12 7 0 0 0 0 0 0 0 0 0 0 0 0 0 0 0 0 0 0 0 0 0 0 
0 0 0 0 0 5 0 0 0 12 2 7 0 0 0 0 0 0 0 0 0 0 0 0 0 0 0 0 0 0 0 0 
0 0 0 0 0 8 11 0 0 0 0 12 2 2 2 2 2 2 7 0 0 0 0 0 0 0 0 0 0 0 0 0 
0 0 0 0 0 0 5 0 0 0 0 0 0 0 0 0 0 0 12 2 2 2 7 0 0 0 0 0 0 0 0 0 
0 0 0 0 0 0 8 4 4 4 11 0 0 0 0 0 0 0 0 0 0 0 12 2 7 0 0 0 0 0 0 0 
0 0 0 0 0 0 0 0 0 0 8 4 4 11 0 0 0 0 0 0 0 0 0 0 3 0 0 0 0 0 0 0 
0 0 0 0 0 0 0 0 0 0 0 0 0 5 0 0 0 9 8 9 8 0 0 0 12 7 0 0 0 0 0 0 
0 0 0 0 0 0 0 0 0 0 0 0 6 13 0 0 0 7 1 0 1 0 0 0 0 3 0 0 0 0 0 0 
0 0 0 0 0 0 0 0 0 0 0 6 13 0 0 0 0 0 0 7 0 8 0 0 0 12 7 0 0 0 0 0 
0 0 0 0 0 0 0 0 0 6 2 13 0 0 0 0 0 0 0 0 7 6 0 0 0 0 3 0 0 0 0 0 
0 0 0 0 0 0 0 0 6 13 0 0 0 0 0 0 0 0 0 0 0 0 0 0 0 0 3 0 0 0 0 0 
0 0 0 0 0 0 0 6 13 0 0 0 0 0 0 0 0 0 0 0 0 0 0 0 0 10 9 0 0 0 0 0 
0 0 0 0 0 6 2 13 0 0 0 0 0 0 0 0 10 4 4 4 11 0 0 10 4 9 0 0 0 0 0 0 
0 0 0 0 0 5 0 0 0 0 0 0 0 10 4 4 9 0 0 0 8 4 4 9 0 0 0 0 0 0 0 0 
0 0 0 0 0 5 0 0 0 0 0 10 4 9 0 0 0 0 0 0 0 0 0 0 0 0 0 0 0 0 0 0 
0 0 0 0 0 5 0 0 0 0 10 9 0 0 0 0 0 0 0 0 0 0 0 0 0 0 0 0 0 0 0 0 
0 0 0 0 6 13 0 0 0 10 9 0 0 0 0 0 0 0 0 0 0 0 0 0 0 0 0 0 0 0 0 0 
0 0 0 0 5 0 0 0 0 3 0 0 0 0 0 0 0 0 0 0 0 0 0 0 0 0 0 0 0 0 0 0 
0 0 0 0 5 0 0 0 0 3 0 0 0 0 0 0 0 0 0 0 0 0 0 0 0 0 0 0 0 0 0 0 
0 0 0 0 5 0 0 0 0 3 0 0 0 0 0 0 0 0 0 0 0 0 0 0 0 0 0 0 0 0 0 0 
0 0 0 0 5 0 0 0 0 12 7 0 0 0 1 1 0 0 0 0 0 0 0 0 0 0 0 0 0 0 0 0 
0 0 0 0 5 0 0 0 0 0 12 2 2 2 0 0 2 2 7 0 0 0 0 0 0 0 0 0 0 0 0 0 
0 0 0 0 8 11 0 0 0 0 0 0 0 0 0 0 0 0 12 2 2 2 2 7 0 0 0 0 0 0 0 0 
0 0 0 0 0 5 0 0 0 0 0 0 0 0 0 0 0 0 0 0 0 0 0 12 2 7 0 0 0 0 0 0 
0 0 0 0 0 5 0 0 0 0 0 0 0 0 0 0 0 0 0 0 0 0 0 0 0 3 0 0 0 0 0 0 
0 0 0 0 0 5 0 0 0 0 0 0 0 0 0 10 4 4 4 4 4 11 0 0 0 12 2 1 0 0 0 0 
0 0 0 0 0 8 11 0 0 0 0 0 0 10 4 9 0 0 0 0 0 8 4 11 0 0 0 1 0 0 0 0 
0 0 0 0 0 0 8 4 4 4 4 4 4 9 0 0 0 0 0 0 0 0 0 8 11 0 0 7 0 0 0 0 
0 0 0 0 0 0 0 0 0 0 0 0 0 0 0 0 0 0 0 0 0 0 0 0 5 0 0 0 1 0 0 0 
0 0 0 0 0 0 0 0 0 0 0 0 0 0 0 0 0 0 0 0 0 0 0 0 5 0 0 0 1 0 0 0 
0 0 0 0 0 0 0 0 0 0 0 0 0 0 0 0 0 0 0 0 0 0 0 0 8 11 0 0 1 0 0 0 
0 0 0 0 0 0 0 0 0 0 0 0 0 0 0 0 0 0 0 0 0 0 0 0 0 5 0 0 1 0 0 0 
0 0 0 0 0 0 0 0 0 0 0 0 0 0 0 0 0 0 0 0 0 0 0 0 6 13 0 0 1 0 0 0 
0 0 0 0 0 0 0 0 0 0 0 0 0 0 0 0 0 0 0 0 0 0 0 0 5 0 0 0 1 0 0 0 
0 0 0 0 0 0 0 0 0 0 0 0 0 6 2 2 2 2 7 0 0 0 0 6 13 0 0 0 1 0 0 0 
0 0 0 0 0 0 0 0 0 0 6 2 2 13 0 0 0 0 12 2 2 7 6 13 0 0 0 9 0 0 0 0 
0 0 0 0 0 0 0 6 7 6 13 0 0 0 0 0 0 0 0 0 0 12 13 0 0 0 0 1 0 0 0 0 
0 0 0 0 0 0 6 0 12 13 0 0 0 0 0 10 4 11 0 0 0 0 0 0 0 0 9 0 0 0 0 0 
0 0 0 0 1 6 0 0 0 0 0 0 0 10 4 9 0 8 4 4 4 4 4 4 4 4 1 0 0 0 0 0 
0 0 0 1 0 0 0 0 0 0 0 0 0 3 0 0 0 0 0 0 0 0 0 0 0 0 0 0 0 0 0 0 
0 0 0 1 0 0 0 0 0 0 0 0 0 12 7 0 0 0 0 0 0 0 0 0 0 0 0 0 0 0 0 0 
0 0 0 6 0 0 0 0 0 0 0 0 0 0 12 2 2 7 0 0 0 0 0 0 0 0 0 0 0 0 0 0 
0 0 1 0 0 0 0 0 0 0 0 0 0 0 0 0 0 9 0 0 0 0 0 0 0 0 0 0 0 0 0 0 
0 0 6 0 0 0 0 0 0 0 0 0 0 0 0 0 9 0 0 0 0 0 0 0 0 0 0 0 0 0 0 0 
0 1 0 0 0 0 0 0 0 0 0 0 0 0 0 0 1 0 0 0 0 0 0 0 0 0 0 0 0 0 0 0 
0 0 8 4 0 0 0 0 0 0 0 0 0 0 0 9 1 0 0 0 0 0 0 0 0 0 0 0 0 0 0 0 
0 0 0 0 8 0 0 0 0 0 0 0 0 0 4 1 0 0 0 0 0 0 0 0 0 0 0 0 0 0 0 0 
0 0 0 0 1 0 0 0 0 0 0 0 0 9 0 0 0 0 0 0 0 0 0 0 0 0 0 0 0 0 0 0 
0 0 0 0 0 8 0 0 0 0 0 0 0 1 0 0 0 0 0 0 0 0 0 0 0 0 0 0 0 0 0 0 
0 0 0 0 0 1 0 0 0 0 0 0 9 0 0 0 0 0 0 0 0 0 0 0 0 0 0 0 0 0 0 0 
0 0 0 0 0 0 8 0 0 0 0 0 1 0 0 0 0 0 0 0 0 0 0 0 0 0 0 0 0 0 0 0 
0 0 0 0 0 0 1 0 0 0 0 9 0 0 0 0 0 0 0 0 0 0 0 0 0 0 0 0 0 0 0 0 
