[TILESET]
SnowSheet

[TERRAIN]
36 36 36 36 36 36 36 36 36 36 36 56 48 73 65 65 65 65 65 65 65 65 65 65 65 65 65 65 65 65 65 65 65 65 65 65 65 65 65 65 65 65 65 65 65 65 65 65 65 65 65 65 65 65 65 65 65 65 65 65 
36 36 36 36 36 36 36 36 36 36 36 36 33 71 68 65 65 65 65 65 65 65 65 65 65 65 65 65 65 65 65 65 65 65 65 65 65 65 65 65 65 65 65 65 65 65 65 65 65 65 65 65 65 65 65 65 65 65 65 65 
39 36 36 36 36 36 36 36 36 36 36 36 33 75 65 65 65 65 65 65 65 65 65 65 65 65 65 65 65 65 65 65 65 65 65 65 65 65 65 65 65 65 64 64 64 64 65 65 65 65 65 65 65 65 65 65 65 65 65 65 
39 39 39 36 36 36 36 36 36 36 36 36 33 68 65 65 65 65 65 65 65 65 65 65 65 65 65 65 65 65 65 65 65 65 65 65 65 65 65 65 65 72 69 69 69 69 73 65 65 65 65 65 65 65 65 65 65 65 65 65 
39 39 39 39 36 36 36 36 36 36 36 59 50 68 65 65 65 65 65 65 65 65 65 65 65 64 64 64 64 64 64 65 65 65 65 65 65 65 65 65 72 70 1 1 1 1 71 73 65 65 65 65 65 65 65 65 65 65 65 65 
39 39 39 39 39 36 36 36 36 36 36 33 75 65 65 65 65 65 65 65 65 65 64 64 72 69 69 69 69 69 69 68 65 65 65 65 65 65 65 67 70 1 1 1 1 1 1 71 73 65 65 65 65 65 65 65 65 65 64 65 
39 39 39 39 39 39 39 59 34 34 34 50 73 65 65 65 65 65 65 65 65 72 69 69 70 1 1 1 1 1 1 73 65 65 65 65 65 65 65 72 1 1 1 1 1 1 1 1 71 68 65 65 65 65 64 64 64 72 69 73 
39 39 39 39 39 39 39 33 1 1 1 1 71 68 65 65 65 65 65 65 67 70 1 1 1 1 1 1 1 1 1 71 68 65 65 65 65 65 72 70 1 1 1 1 1 1 1 1 1 73 65 65 64 72 69 69 69 70 1 71 
39 39 39 39 39 39 59 50 9 8 1 1 1 68 65 65 65 65 65 65 67 1 1 1 1 25 24 1 1 1 1 1 68 65 65 65 65 67 70 1 1 1 1 1 66 66 1 1 1 71 73 72 69 70 1 1 1 1 1 1 
39 39 39 39 39 39 55 9 14 15 8 1 1 68 65 65 65 65 65 65 72 1 1 1 25 28 30 16 24 1 1 1 73 65 65 65 64 72 1 1 1 1 66 75 65 65 74 1 1 1 71 70 1 1 1 1 1 1 1 1 
39 39 39 39 39 39 47 7 3 3 5 1 75 65 65 65 65 65 65 67 70 1 1 1 19 2 2 2 18 1 1 1 71 73 64 72 69 70 1 1 1 75 65 65 65 65 65 74 1 1 1 1 1 1 1 1 1 1 66 66 
39 39 39 39 39 39 33 11 12 3 5 1 68 65 65 65 65 65 65 67 1 1 1 1 19 2 2 29 26 1 1 1 1 71 69 70 1 1 1 1 75 65 65 65 65 65 65 67 1 1 1 1 1 1 1 1 1 75 65 65 
39 39 39 39 39 59 50 1 11 12 5 1 68 65 65 65 65 65 65 67 1 1 1 1 27 17 17 26 1 1 1 1 1 1 1 1 1 1 1 1 68 65 65 65 65 65 65 72 1 1 1 1 1 1 1 66 75 65 65 65 
39 39 39 39 39 33 1 1 1 11 10 1 68 65 65 65 65 65 65 67 1 1 1 1 1 1 1 1 1 1 1 1 1 1 1 1 1 1 1 1 73 65 65 65 65 65 67 70 1 1 1 1 1 1 75 65 65 65 65 65 
39 39 39 39 59 50 1 1 9 6 8 1 73 64 65 65 65 65 65 65 74 66 1 1 1 1 1 1 1 1 66 66 66 66 66 1 1 1 1 1 71 68 65 65 65 65 67 1 1 1 1 1 1 75 65 65 65 65 65 65 
39 39 39 39 33 1 1 9 14 3 15 8 71 69 73 65 65 65 65 65 65 65 74 66 66 66 66 66 66 75 65 65 65 65 65 74 66 1 1 1 1 73 65 65 65 65 72 1 1 1 1 1 1 68 65 65 65 65 65 65 
39 39 39 39 33 1 1 11 12 3 3 15 6 8 71 73 65 65 65 65 65 65 65 65 65 65 65 65 65 65 65 65 65 65 65 65 65 74 1 1 1 71 73 64 64 72 70 1 1 1 1 1 1 73 65 65 65 65 65 65 
39 39 39 59 50 1 1 1 11 4 12 3 3 15 8 71 73 64 65 65 65 65 65 65 65 65 65 65 65 65 65 65 65 65 65 65 64 72 1 1 1 1 71 69 69 70 1 1 1 1 1 1 1 71 68 65 65 65 65 65 
34 34 34 50 75 74 66 66 66 1 11 12 3 13 10 1 71 69 68 65 65 65 65 65 65 65 65 65 65 65 65 65 65 64 64 72 69 70 1 1 1 1 1 1 1 1 1 1 1 1 1 1 1 1 73 65 65 65 65 65 
66 66 66 75 65 65 65 65 65 74 66 11 4 10 1 1 1 1 73 64 64 65 65 65 65 65 65 65 65 65 65 64 72 69 69 70 1 1 1 1 1 1 1 1 1 1 1 66 1 1 1 1 1 1 71 68 65 65 65 65 
65 65 65 65 65 65 65 65 65 65 65 74 66 1 1 1 1 1 71 69 69 73 65 65 65 65 65 65 65 65 72 69 70 1 1 1 1 1 1 1 1 1 1 1 1 66 75 65 74 1 1 1 1 1 1 68 65 65 65 65 
65 65 65 65 65 65 65 65 65 65 65 65 65 74 66 66 66 1 1 1 1 71 73 64 65 65 65 65 65 72 70 9 6 8 1 1 1 1 1 1 1 1 1 1 75 65 65 65 65 74 1 1 1 1 1 73 65 65 65 65 
65 65 65 65 65 65 65 65 65 65 65 65 65 65 65 65 65 74 1 1 9 8 71 69 73 64 64 64 72 70 1 7 3 5 1 66 75 74 66 1 1 1 1 1 68 65 65 65 65 67 1 1 1 1 1 71 68 65 65 65 
65 65 65 65 65 65 65 65 65 65 65 65 65 65 65 65 65 67 66 1 11 10 9 8 71 69 69 69 70 9 8 11 4 10 75 65 65 65 65 74 1 1 1 75 65 65 65 65 65 72 1 1 1 1 1 1 68 65 65 65 
65 65 65 65 65 65 65 65 65 65 65 65 65 65 65 65 65 65 65 74 1 9 14 15 8 9 6 6 6 14 5 1 1 1 68 65 65 65 65 65 74 66 66 68 65 65 65 64 72 70 1 1 1 1 1 1 68 65 65 65 
65 65 65 65 65 65 65 65 65 65 65 65 65 65 65 65 65 65 65 67 1 11 12 3 15 14 3 13 4 12 15 6 8 1 73 64 65 65 65 65 65 65 65 65 65 65 72 69 70 1 1 1 1 1 1 75 65 65 65 65 
65 65 65 65 65 65 65 65 65 65 65 65 65 65 65 65 65 65 65 72 1 9 14 3 3 13 4 10 1 11 4 12 5 1 71 69 73 65 65 65 65 65 65 65 65 72 70 1 1 1 1 1 1 1 1 68 65 65 65 64 
65 65 65 65 65 65 65 65 65 65 64 64 64 64 64 65 65 65 72 70 9 14 3 13 4 10 66 66 66 66 1 11 10 1 1 1 71 68 65 65 65 65 65 65 67 70 1 1 1 1 1 1 1 1 75 65 65 65 72 69 
65 65 65 65 65 65 65 64 64 72 69 69 69 69 69 73 64 72 70 1 7 13 4 10 1 75 65 65 65 65 74 1 1 9 6 8 1 73 64 65 65 65 65 65 67 1 1 1 1 1 1 1 1 1 68 65 65 72 86 49 
65 65 65 65 65 65 72 69 69 70 9 6 6 6 8 71 69 70 1 1 11 10 1 1 75 65 65 65 65 65 65 74 1 11 12 5 1 71 69 73 65 65 65 65 72 1 1 1 1 1 1 1 1 75 65 65 72 86 49 58 
64 64 64 64 65 67 1 1 9 6 14 13 4 12 15 8 1 1 1 1 1 66 66 75 65 65 65 65 65 65 65 65 74 1 11 10 1 1 1 71 73 64 64 72 70 1 1 1 1 1 1 1 75 65 65 67 70 49 58 36 
69 69 69 69 73 72 1 9 14 3 13 10 1 11 12 15 8 1 1 1 75 65 65 65 65 64 64 64 64 64 65 65 67 1 1 1 1 1 1 1 71 69 69 70 1 1 1 1 1 1 66 75 65 65 64 72 49 58 36 36 
42 42 42 48 71 70 1 11 12 3 15 6 6 6 14 13 10 1 1 1 73 64 64 64 72 69 69 69 69 69 73 65 65 74 1 1 1 1 1 1 1 1 1 1 1 1 1 1 66 75 65 65 65 67 69 86 41 36 36 36 
36 36 36 56 42 42 42 48 11 12 3 3 3 3 13 10 49 42 42 48 71 69 69 69 86 49 42 42 42 48 71 73 64 72 1 1 1 66 1 1 1 1 1 1 1 1 66 75 65 65 65 65 65 72 49 42 58 36 36 36 
36 36 36 36 36 36 36 56 48 11 4 4 4 4 10 49 58 36 36 56 42 42 48 49 42 58 36 36 36 56 48 71 69 70 1 1 75 65 74 66 66 66 66 66 66 75 65 65 65 64 64 64 72 70 41 36 36 36 36 36 
36 36 36 36 36 36 36 36 56 42 42 42 42 42 42 58 36 36 36 36 36 36 56 58 36 36 36 36 36 36 56 42 48 1 1 1 73 64 64 64 64 64 64 64 64 64 64 64 72 69 69 69 86 49 58 36 36 36 36 36 
36 36 36 36 36 36 36 36 36 36 36 36 36 36 36 36 36 36 36 36 36 36 36 36 36 36 36 36 36 36 36 36 56 42 42 48 71 69 69 69 69 69 69 69 69 69 69 69 70 49 42 42 42 58 36 36 36 36 36 36 
36 36 36 36 36 36 36 36 36 36 36 36 36 36 36 36 36 36 36 36 36 36 36 36 36 36 36 36 36 36 36 36 36 36 36 56 42 42 42 42 42 42 42 42 42 42 42 42 42 58 36 36 36 36 36 36 36 36 36 36 
36 36 36 36 36 36 36 36 36 36 36 36 36 36 36 36 36 36 36 36 36 36 36 36 36 36 36 36 36 36 36 36 36 36 36 36 36 36 36 36 36 36 36 36 36 36 36 36 36 36 36 36 36 36 36 36 36 36 36 36 
36 36 36 36 36 36 36 36 36 36 36 36 36 36 36 36 36 36 36 36 36 36 36 36 36 36 36 36 36 36 36 36 36 36 36 36 36 36 36 36 36 36 36 36 36 36 36 36 36 36 36 36 36 36 36 36 36 36 36 36 

[COLLISION]
0 0 0 0 0 0 0 0 0 0 0 0 0 0 0 0 0 0 0 0 0 0 0 0 0 0 0 0 0 0 0 0 0 0 0 0 0 0 0 0 0 0 0 0 0 0 0 0 0 0 0 0 0 0 0 0 0 0 0 0 
0 0 0 0 0 0 0 0 0 0 0 0 0 0 0 0 0 0 0 0 0 0 0 0 0 0 0 0 0 0 0 0 0 0 0 0 0 0 0 0 0 0 0 0 0 0 0 0 0 0 0 0 0 0 0 0 0 0 0 0 
0 0 0 0 0 0 0 0 0 0 0 0 0 0 0 0 0 0 0 0 0 0 0 0 0 0 0 0 0 0 0 0 0 0 0 0 0 0 0 0 0 0 1 1 1 1 0 0 0 0 0 0 0 0 0 0 0 0 0 0 
0 0 0 0 0 0 0 0 0 0 0 0 0 0 0 0 0 0 0 0 0 0 0 0 0 0 0 0 0 0 0 0 0 0 0 0 0 0 0 0 0 6 0 0 0 0 7 0 0 0 0 0 0 0 0 0 0 0 0 0 
0 0 0 0 0 0 0 0 0 0 0 0 0 0 0 0 0 0 0 0 0 0 0 0 0 1 1 1 1 1 1 0 0 0 0 0 0 0 0 0 6 0 0 0 0 0 0 7 0 0 0 0 0 0 0 0 0 0 0 0 
0 0 0 0 0 0 0 0 0 0 0 0 0 0 0 0 0 0 0 0 0 0 1 1 6 0 0 0 0 0 0 1 0 0 0 0 0 0 0 1 0 0 0 0 0 0 0 0 7 0 0 0 0 0 0 0 0 0 1 0 
0 0 0 0 0 0 0 6 2 2 2 2 7 0 0 0 0 0 0 0 0 6 0 0 0 0 0 0 0 0 0 7 0 0 0 0 0 0 0 6 0 0 0 0 0 0 0 0 0 1 0 0 0 0 1 1 1 6 0 7 
0 0 0 0 0 0 0 5 0 0 0 0 0 1 0 0 0 0 0 0 1 0 0 0 0 0 0 0 0 0 0 0 1 0 0 0 0 0 6 0 0 0 0 0 0 0 0 0 0 7 0 0 1 6 0 0 0 0 0 0 
0 0 0 0 0 0 6 13 0 0 0 0 0 1 0 0 0 0 0 0 1 0 0 0 0 10 11 0 0 0 0 0 1 0 0 0 0 1 0 0 0 0 0 0 4 4 0 0 0 0 7 6 0 0 0 0 0 0 0 0 
0 0 0 0 0 1 0 0 0 0 0 0 0 1 0 0 0 0 0 0 6 0 0 0 10 9 8 4 11 0 0 0 7 0 0 0 1 6 0 0 0 0 4 9 0 0 8 0 0 0 0 0 0 0 0 0 0 0 0 0 
0 0 0 0 0 1 0 0 0 0 0 0 9 0 0 0 0 0 0 1 0 0 0 0 3 0 0 0 5 0 0 0 0 7 1 6 0 0 0 0 0 9 0 0 0 0 0 8 0 0 0 0 0 0 0 0 0 0 4 4 
0 0 0 0 0 0 5 0 0 0 0 0 1 0 0 0 0 0 0 1 0 0 0 0 3 0 0 6 13 0 0 0 0 0 0 0 0 0 0 0 9 0 0 0 0 0 0 1 0 0 0 0 0 0 0 0 0 9 0 0 
0 0 0 0 0 6 13 0 0 0 0 0 1 0 0 0 0 0 0 1 0 0 0 0 12 2 2 13 0 0 0 0 0 0 0 0 0 0 0 0 1 0 0 0 0 0 0 6 0 0 0 0 0 0 0 4 9 0 0 0 
0 0 0 0 0 5 0 0 0 0 0 0 1 0 0 0 0 0 0 1 0 0 0 0 0 0 0 0 0 0 0 0 0 0 0 0 0 0 0 0 7 0 0 0 0 0 1 0 0 0 0 0 0 0 9 0 0 0 0 0 
0 0 0 0 6 13 0 0 0 0 0 0 7 1 0 0 0 0 0 0 8 4 0 0 0 0 0 0 0 0 4 4 4 4 4 0 0 0 0 0 0 1 0 0 0 0 1 0 0 0 0 0 0 9 0 0 0 0 0 0 
0 0 0 0 5 0 0 0 0 0 0 0 0 0 7 0 0 0 0 0 0 0 8 4 4 4 4 4 4 9 0 0 0 0 0 8 4 0 0 0 0 7 0 0 0 0 6 0 0 0 0 0 0 1 0 0 0 0 0 0 
0 0 0 0 5 0 0 0 0 0 0 0 0 0 0 7 0 0 0 0 0 0 0 0 0 0 0 0 0 0 0 0 0 0 0 0 0 8 0 0 0 0 7 1 1 6 0 0 0 0 0 0 0 7 0 0 0 0 0 0 
0 0 0 0 5 0 0 0 0 0 0 0 0 0 0 0 7 1 0 0 0 0 0 0 0 0 0 0 0 0 0 0 0 0 0 0 1 6 0 0 0 0 0 0 0 0 0 0 0 0 0 0 0 0 1 0 0 0 0 0 
0 0 0 0 2 8 4 4 4 0 0 0 0 0 0 0 0 0 1 0 0 0 0 0 0 0 0 0 0 0 0 0 0 1 1 6 0 0 0 0 0 0 0 0 0 0 0 0 0 0 0 0 0 0 7 0 0 0 0 0 
0 0 0 0 0 0 0 0 0 8 4 0 0 0 0 0 0 0 7 1 1 0 0 0 0 0 0 0 0 0 0 1 6 0 0 0 0 0 0 0 0 0 0 0 0 0 0 4 0 0 0 0 0 0 0 1 0 0 0 0 
0 0 0 0 0 0 0 0 0 0 0 8 4 0 0 0 0 0 0 0 0 7 0 0 0 0 0 0 0 0 6 0 0 0 0 0 0 0 0 0 0 0 0 0 0 4 9 0 8 0 0 0 0 0 0 1 0 0 0 0 
0 0 0 0 0 0 0 0 0 0 0 0 0 8 4 4 4 0 0 0 0 0 7 1 0 0 0 0 0 6 0 0 0 0 0 0 0 0 0 0 0 0 0 0 9 0 0 0 0 8 0 0 0 0 0 7 0 0 0 0 
0 0 0 0 0 0 0 0 0 0 0 0 0 0 0 0 0 8 0 0 0 0 0 0 7 1 1 1 6 0 0 0 0 0 0 4 9 8 4 0 0 0 0 0 1 0 0 0 0 1 0 0 0 0 0 0 1 0 0 0 
0 0 0 0 0 0 0 0 0 0 0 0 0 0 0 0 0 1 4 0 0 0 0 0 0 0 0 0 0 0 0 0 0 0 9 0 0 0 0 8 0 0 0 9 0 0 0 0 0 6 0 0 0 0 0 0 1 0 0 0 
0 0 0 0 0 0 0 0 0 0 0 0 0 0 0 0 0 0 0 8 0 0 0 0 0 0 0 0 0 0 0 0 0 0 1 0 0 0 0 0 8 4 4 1 0 0 0 1 6 0 0 0 0 0 0 0 1 0 0 0 
0 0 0 0 0 0 0 0 0 0 0 0 0 0 0 0 0 0 0 1 0 0 0 0 0 0 0 0 0 0 0 0 0 0 7 1 0 0 0 0 0 0 0 0 0 0 6 0 0 0 0 0 0 0 0 9 0 0 0 0 
0 0 0 0 0 0 0 0 0 0 0 0 0 0 0 0 0 0 0 6 0 0 0 0 0 0 0 0 0 0 0 0 0 0 0 0 7 0 0 0 0 0 0 0 0 6 0 0 0 0 0 0 0 0 0 1 0 0 0 0 
0 0 0 0 0 0 0 0 0 0 1 1 1 1 1 0 0 0 6 0 0 0 0 0 0 0 4 4 4 4 0 0 0 0 0 0 0 1 0 0 0 0 0 0 1 0 0 0 0 0 0 0 0 0 9 0 0 0 0 0 
0 0 0 0 0 0 0 1 1 6 0 0 0 0 0 7 1 6 0 0 0 0 0 0 0 9 0 0 0 0 8 0 0 0 0 0 0 7 1 0 0 0 0 0 1 0 0 0 0 0 0 0 0 0 1 0 0 0 0 0 
0 0 0 0 0 0 6 0 0 0 0 0 0 0 0 0 0 0 0 0 0 0 0 0 9 0 0 0 0 0 0 8 0 0 0 0 0 0 0 7 0 0 0 0 6 0 0 0 0 0 0 0 0 9 0 0 0 0 0 0 
0 0 0 0 0 1 0 0 0 0 0 0 0 0 0 0 0 0 0 0 0 4 4 9 0 0 0 0 0 0 0 0 8 0 0 0 0 0 0 0 7 1 1 6 0 0 0 0 0 0 0 0 9 0 0 0 0 0 0 0 
0 0 0 6 7 6 0 0 0 0 0 0 0 0 0 0 0 0 0 0 9 0 0 0 0 0 0 0 0 0 0 0 1 0 0 0 0 0 0 0 0 0 0 0 0 0 0 0 0 0 4 9 0 0 0 0 0 0 0 0 
0 0 0 5 0 0 0 0 0 0 0 0 0 0 0 0 0 0 0 0 7 0 0 0 0 0 0 0 0 0 0 0 0 8 0 0 0 0 0 0 0 0 0 0 0 0 0 0 4 9 0 0 0 0 0 0 0 0 0 0 
0 0 0 8 4 4 4 11 0 0 0 0 0 0 0 0 10 4 4 4 9 0 0 0 0 0 0 0 0 0 6 7 1 6 0 0 0 4 0 0 0 0 0 0 0 0 4 9 0 0 0 0 0 0 0 0 0 0 0 0 
0 0 0 0 0 0 0 8 11 0 0 0 0 0 0 10 9 0 0 0 0 0 0 0 0 0 0 0 0 0 5 0 0 0 0 0 9 0 8 4 4 4 4 4 4 9 0 0 0 0 0 0 0 0 0 0 0 0 0 0 
0 0 0 0 0 0 0 0 8 4 4 4 4 4 4 9 0 0 0 0 0 0 0 0 0 0 0 0 0 0 8 4 11 0 0 0 7 0 0 0 0 0 0 0 0 0 0 0 0 0 0 0 0 0 0 0 0 0 0 0 
0 0 0 0 0 0 0 0 0 0 0 0 0 0 0 0 0 0 0 0 0 0 0 0 0 0 0 0 0 0 0 0 8 4 4 4 9 0 0 0 0 0 0 0 0 0 0 0 0 0 0 0 0 0 0 0 0 0 0 0 
0 0 0 0 0 0 0 0 0 0 0 0 0 0 0 0 0 0 0 0 0 0 0 0 0 0 0 0 0 0 0 0 0 0 0 0 0 0 0 0 0 0 0 0 0 0 0 0 0 0 0 0 0 0 0 0 0 0 0 0 
0 0 0 0 0 0 0 0 0 0 0 0 0 0 0 0 0 0 0 0 0 0 0 0 0 0 0 0 0 0 0 0 0 0 0 0 0 0 0 0 0 0 0 0 0 0 0 0 0 0 0 0 0 0 0 0 0 0 0 0 
0 0 0 0 0 0 0 0 0 0 0 0 0 0 0 0 0 0 0 0 0 0 0 0 0 0 0 0 0 0 0 0 0 0 0 0 0 0 0 0 0 0 0 0 0 0 0 0 0 0 0 0 0 0 0 0 0 0 0 0 
