[TILESET]
CaveSheet

[TERRAIN]
0 0 0 0 0 0 0 0 0 0 0 0 0 0 0 0 0 0 0 0 0 0 0 0 0 0 0 0 0 0 
0 0 0 0 0 0 0 0 0 0 0 0 0 0 0 0 0 0 0 0 0 0 0 0 0 0 0 0 0 0 
0 0 0 0 0 0 0 0 0 0 0 8 4 4 4 4 4 4 4 4 4 9 0 0 0 0 0 0 0 0 
0 0 0 0 0 0 0 8 4 4 4 12 1 1 1 1 1 1 1 1 1 13 4 4 9 0 0 0 0 0 
0 0 0 0 0 8 4 12 1 1 1 1 1 1 1 1 1 1 1 1 1 1 1 1 13 9 0 0 0 0 
0 0 0 0 8 12 1 1 1 1 1 1 1 1 1 1 1 1 1 1 1 1 1 1 1 7 0 0 0 0 
0 0 0 0 5 1 1 1 1 1 1 1 1 1 1 1 1 1 1 1 1 1 1 1 1 13 9 0 0 0 
0 0 0 0 5 1 1 1 1 1 1 1 1 1 1 1 1 1 1 1 1 1 1 1 1 1 7 0 0 0 
0 0 0 0 5 1 1 1 1 1 1 1 1 1 1 1 1 1 1 1 1 1 1 1 1 1 7 0 0 0 
0 0 0 0 11 15 1 1 1 1 1 1 1 1 1 1 1 1 1 1 1 1 1 1 1 1 7 0 0 0 
0 0 0 0 0 5 1 1 1 1 1 1 1 1 1 1 1 1 1 1 1 1 1 1 1 14 10 0 0 0 
0 0 0 0 0 11 15 1 1 1 1 14 6 6 6 6 6 6 15 1 1 1 1 14 6 10 0 0 0 0 
0 0 0 0 0 0 11 6 15 1 1 7 0 0 0 0 0 0 5 1 1 14 6 10 0 0 0 0 0 0 
0 0 0 0 0 0 0 0 5 1 1 13 9 0 0 0 0 8 12 1 1 7 0 0 0 0 0 0 0 0 
0 0 0 0 0 0 0 8 12 1 1 1 13 4 4 4 4 12 1 1 1 13 4 9 0 0 0 0 0 0 
0 0 0 0 0 0 8 12 1 1 1 1 1 1 1 1 1 1 1 1 1 1 1 13 9 0 0 0 0 0 
0 0 0 0 0 8 12 1 1 1 14 6 6 6 6 6 6 6 15 1 1 1 1 1 13 9 0 0 0 0 
0 0 0 0 0 5 1 1 1 14 10 0 0 0 0 0 0 0 11 6 15 1 1 1 1 7 0 0 0 0 
0 0 0 0 8 12 1 1 14 10 0 0 0 0 0 0 0 0 0 0 11 6 15 1 1 7 0 0 0 0 
0 0 0 8 12 1 1 1 7 0 0 0 0 0 0 0 0 0 0 0 0 0 11 6 6 10 0 0 0 0 
0 0 0 5 1 1 1 1 7 0 0 0 0 0 8 4 4 9 0 0 0 0 0 0 0 0 0 0 0 0 
0 0 0 11 15 1 1 1 13 9 0 0 0 8 12 1 1 13 4 9 0 0 0 0 0 0 0 0 0 0 
0 0 0 0 5 1 1 1 1 13 4 4 4 12 1 1 1 1 1 13 4 9 0 0 0 0 0 0 0 0 
0 0 0 0 11 15 1 1 1 1 1 1 1 1 1 1 1 1 1 1 1 13 9 0 0 0 0 0 0 0 
0 0 0 0 0 11 15 1 1 1 1 1 1 1 14 6 15 1 1 1 1 1 7 0 0 0 0 0 0 0 
0 0 0 0 0 0 11 15 1 1 1 1 1 14 10 0 11 15 1 1 1 1 13 9 0 0 0 0 0 0 
0 0 0 0 0 0 0 11 6 6 6 6 6 10 0 0 0 11 15 1 1 1 14 10 0 0 0 0 0 0 
0 0 0 0 0 0 0 0 0 0 0 0 0 0 0 0 0 0 11 6 22 18 10 0 0 0 0 0 0 0 
0 0 0 0 0 0 0 0 0 0 0 0 0 0 0 0 0 0 0 0 0 0 0 0 0 0 0 0 0 0 
0 0 0 0 0 0 0 0 0 0 0 0 0 0 0 0 0 0 0 0 0 0 0 0 0 0 0 0 0 0 

[COLLISION]
0 0 0 0 0 0 0 0 0 0 0 0 0 0 0 0 0 0 0 0 0 0 0 0 0 0 0 0 0 0 
0 0 0 0 0 0 0 0 0 0 0 0 0 0 0 0 0 0 0 0 0 0 0 0 0 0 0 0 0 0 
0 0 0 0 0 0 0 0 0 0 0 6 2 2 2 2 2 2 2 2 2 7 0 0 0 0 0 0 0 0 
0 0 0 0 0 0 0 6 2 2 2 13 0 0 0 0 0 0 0 0 0 12 2 2 7 0 0 0 0 0 
0 0 0 0 0 6 2 13 0 0 0 0 0 0 0 0 0 0 0 0 0 0 0 0 12 7 0 0 0 0 
0 0 0 0 6 13 0 0 0 0 0 0 0 0 0 0 0 0 0 0 0 0 0 0 0 3 0 0 0 0 
0 0 0 0 5 0 0 0 0 0 0 0 0 0 0 0 0 0 0 0 0 0 0 0 0 12 7 0 0 0 
0 0 0 0 5 0 0 0 0 0 0 0 0 0 0 0 0 0 0 0 0 0 0 0 0 0 3 0 0 0 
0 0 0 0 5 0 0 0 0 0 0 0 0 0 0 0 0 0 0 0 0 0 0 0 0 0 3 0 0 0 
0 0 0 0 8 11 0 0 0 0 0 0 0 0 0 0 0 0 0 0 0 0 0 0 0 0 3 0 0 0 
0 0 0 0 0 5 0 0 0 0 0 0 0 0 0 0 0 0 0 0 0 0 0 0 0 10 9 0 0 0 
0 0 0 0 0 8 11 0 0 0 0 10 4 4 4 4 4 4 11 0 0 0 0 10 4 9 0 0 0 0 
0 0 0 0 0 0 8 4 11 0 0 3 0 0 0 0 0 0 5 0 0 10 4 9 0 0 0 0 0 0 
0 0 0 0 0 0 0 0 5 0 0 12 7 0 0 0 0 6 13 0 0 3 0 0 0 0 0 0 0 0 
0 0 0 0 0 0 0 6 13 0 0 0 12 2 2 2 2 13 0 0 0 12 2 7 0 0 0 0 0 0 
0 0 0 0 0 0 6 13 0 0 0 0 0 0 0 0 0 0 0 0 0 0 0 12 7 0 0 0 0 0 
0 0 0 0 0 6 13 0 0 0 10 4 4 4 4 4 4 4 11 0 0 0 0 0 12 7 0 0 0 0 
0 0 0 0 0 5 0 0 0 10 9 0 0 0 0 0 0 0 8 4 11 0 0 0 0 3 0 0 0 0 
0 0 0 0 6 13 0 0 10 9 0 0 0 0 0 0 0 0 0 0 8 4 11 0 0 3 0 0 0 0 
0 0 0 6 13 0 0 0 3 0 0 0 0 0 0 0 0 0 0 0 0 0 8 4 4 9 0 0 0 0 
0 0 0 5 0 0 0 0 3 0 0 0 0 0 6 2 2 7 0 0 0 0 0 0 0 0 0 0 0 0 
0 0 0 8 11 0 0 0 12 7 0 0 0 6 13 0 0 12 2 7 0 0 0 0 0 0 0 0 0 0 
0 0 0 0 5 0 0 0 0 12 2 2 2 13 0 0 0 0 0 12 2 7 0 0 0 0 0 0 0 0 
0 0 0 0 8 11 0 0 0 0 0 0 0 0 0 0 0 0 0 0 0 12 7 0 0 0 0 0 0 0 
0 0 0 0 0 8 11 0 0 0 0 0 0 0 10 4 11 0 0 0 0 0 3 0 0 0 0 0 0 0 
0 0 0 0 0 0 8 11 0 0 0 0 0 10 9 0 8 11 0 0 0 0 12 7 0 0 0 0 0 0 
0 0 0 0 0 0 0 8 4 4 4 4 4 9 0 0 0 8 11 0 0 0 10 9 0 0 0 0 0 0 
0 0 0 0 0 0 0 0 0 0 0 0 0 0 0 0 0 0 8 4 0 0 9 0 0 0 0 0 0 0 
0 0 0 0 0 0 0 0 0 0 0 0 0 0 0 0 0 0 0 0 1 1 0 0 0 0 0 0 0 0 
0 0 0 0 0 0 0 0 0 0 0 0 0 0 0 0 0 0 0 0 0 0 0 0 0 0 0 0 0 0 
