[TILESET]
CaveSheet

[TERRAIN]
0 0 0 0 0 0 0 0 0 0 0 0 0 0 0 0 0 0 0 0 0 0 0 0 0 0 0 0 0 0 0 0 0 0 0 0 0 0 0 0 
0 0 0 0 0 0 0 0 0 0 0 0 0 0 0 0 0 0 0 0 0 0 0 0 0 0 0 0 0 0 0 0 0 0 0 0 0 0 0 0 
0 0 0 0 0 0 0 0 0 0 0 0 0 0 0 0 0 0 0 0 0 0 8 4 4 9 0 0 0 0 0 0 0 0 0 0 0 0 0 0 
0 0 0 0 0 0 0 0 0 8 4 9 0 0 0 0 0 0 0 0 8 4 12 1 1 13 4 9 0 0 0 0 0 0 0 0 0 0 0 0 
0 0 0 0 0 0 8 4 4 12 1 13 4 9 0 0 0 0 0 8 12 1 1 1 1 1 1 13 9 0 8 4 4 9 0 0 0 0 0 0 
0 0 0 0 0 8 12 1 1 1 1 1 1 13 4 4 4 4 4 12 1 1 1 1 1 1 1 1 13 4 12 1 1 13 4 9 0 0 0 0 
0 0 0 0 0 5 1 1 1 1 1 1 1 1 1 1 1 1 1 1 1 1 30 25 25 28 1 1 1 1 1 1 1 1 1 13 9 0 0 0 
0 0 0 0 8 12 1 1 1 1 1 1 1 1 1 1 1 1 1 1 1 1 26 37 37 24 1 1 1 1 1 1 1 1 1 1 7 0 0 0 
0 0 0 0 5 1 1 1 1 1 30 25 25 28 1 1 1 1 1 1 30 25 32 37 37 34 25 28 1 1 1 1 1 1 1 1 17 0 0 0 
0 0 0 8 12 1 1 1 1 30 32 37 37 34 28 1 1 1 1 30 32 37 37 37 37 37 37 24 1 1 1 1 1 1 1 1 21 0 0 0 
0 0 0 5 1 1 1 1 1 26 37 37 37 37 34 28 1 30 25 32 37 37 37 37 37 37 37 34 28 1 1 1 1 1 1 1 7 0 0 0 
0 0 0 5 1 1 1 1 1 31 33 37 37 37 37 34 25 32 37 37 37 37 37 37 37 37 37 37 34 25 28 1 1 1 1 14 10 0 0 0 
0 0 0 11 15 1 1 1 1 1 26 37 37 37 37 37 37 35 27 27 33 37 37 37 37 37 37 37 37 37 24 1 1 14 6 10 0 0 0 0 
0 0 0 0 5 1 1 1 1 1 26 37 37 37 37 35 27 29 1 1 31 27 33 37 37 37 37 37 37 35 29 1 1 13 9 0 0 0 0 0 
0 0 0 0 11 6 15 1 1 1 41 53 53 53 53 43 1 1 1 1 1 1 31 33 37 37 37 37 37 24 1 1 1 1 13 9 0 0 0 0 
0 0 0 0 0 0 11 15 1 1 49 38 38 38 38 51 1 1 1 1 1 1 1 31 33 37 37 37 37 24 1 1 1 1 1 7 0 0 0 0 
0 0 0 0 0 8 4 12 1 1 40 52 52 52 52 42 1 1 1 1 1 1 1 30 32 37 37 37 35 29 1 1 1 1 1 7 0 0 0 0 
0 0 0 0 8 12 1 1 1 30 32 37 37 37 37 24 1 1 1 1 1 1 1 26 37 37 37 37 24 1 1 1 1 1 1 7 0 0 0 0 
0 0 0 0 5 1 1 1 1 31 33 37 37 37 37 34 25 25 28 1 1 1 30 32 37 37 37 37 34 28 1 1 1 1 1 7 0 0 0 0 
0 0 0 8 12 1 1 1 1 1 31 27 33 37 37 37 37 37 34 28 1 30 32 37 37 37 37 37 37 34 28 1 1 1 14 10 0 0 0 0 
0 0 0 5 1 1 1 1 1 1 1 1 31 27 33 37 37 37 37 34 25 32 37 37 37 37 37 37 37 37 24 1 14 6 10 0 0 0 0 0 
0 0 0 11 15 1 1 1 1 1 1 1 1 1 31 33 37 37 37 37 37 37 37 37 37 37 37 37 37 37 24 1 7 0 0 0 0 0 0 0 
0 0 0 0 11 15 1 1 1 1 1 1 1 1 1 31 33 37 37 37 37 37 37 37 37 37 37 37 37 35 29 1 7 0 0 0 0 0 0 0 
0 0 0 0 0 11 15 1 1 1 1 1 1 1 1 30 32 37 37 37 37 37 37 37 37 37 37 37 35 29 1 1 13 9 0 0 0 0 0 0 
0 0 0 0 0 0 11 6 6 15 1 1 1 1 30 32 37 37 37 37 37 37 37 37 37 37 37 37 24 1 1 1 1 7 0 0 0 0 0 0 
0 0 0 0 0 0 0 0 0 11 15 1 1 1 26 37 37 37 37 37 37 37 35 27 33 37 37 35 29 1 1 1 1 13 9 0 0 0 0 0 
0 0 0 0 0 0 0 0 0 0 5 1 1 1 31 27 33 37 37 37 37 35 29 1 31 27 27 29 1 1 1 1 1 1 13 9 0 0 0 0 
0 0 0 0 0 0 0 0 0 8 12 1 1 1 1 1 31 27 33 37 37 24 1 1 1 1 1 1 1 1 1 1 1 1 1 13 9 0 0 0 
0 0 0 0 0 0 0 8 4 12 1 1 1 1 1 1 1 1 31 27 27 29 1 1 1 1 1 1 1 1 1 1 1 1 1 1 13 9 0 0 
0 0 0 0 0 0 8 12 1 1 1 1 1 1 1 1 1 1 1 1 1 1 1 1 1 1 1 1 1 14 6 15 1 1 1 1 1 7 0 0 
0 0 0 0 0 8 12 1 1 1 1 1 1 1 1 1 1 1 1 1 1 1 1 1 1 1 1 1 1 7 0 11 15 1 1 1 14 10 0 0 
0 0 0 0 8 12 1 1 1 1 1 1 1 1 1 14 6 6 15 1 1 1 1 1 1 1 1 1 1 7 0 0 11 15 1 14 10 0 0 0 
0 0 0 0 5 1 1 1 1 1 1 1 1 14 6 10 0 0 11 15 1 1 1 1 1 1 1 1 14 10 0 0 0 11 6 10 0 0 0 0 
0 0 0 0 11 15 1 1 1 1 1 14 6 10 0 0 0 0 0 5 1 1 1 1 1 1 1 1 7 0 0 0 0 0 0 0 0 0 0 0 
0 0 0 0 0 11 15 1 1 1 14 10 0 0 0 0 0 0 0 11 6 15 1 1 1 1 1 14 10 0 0 0 0 0 0 0 0 0 0 0 
0 0 0 0 0 0 11 6 15 14 10 0 0 0 0 0 0 0 0 0 0 11 15 1 1 14 6 10 0 0 0 0 0 0 0 0 0 0 0 0 
0 0 0 0 0 0 0 0 11 10 0 0 0 0 0 0 0 0 0 0 0 0 11 22 18 10 0 0 0 0 0 0 0 0 0 0 0 0 0 0 
0 0 0 0 0 0 0 0 0 0 0 0 0 0 0 0 0 0 0 0 0 0 0 0 0 0 0 0 0 0 0 0 0 0 0 0 0 0 0 0 
0 0 0 0 0 0 0 0 0 0 0 0 0 0 0 0 0 0 0 0 0 0 0 0 0 0 0 0 0 0 0 0 0 0 0 0 0 0 0 0 
0 0 0 0 0 0 0 0 0 0 0 0 0 0 0 0 0 0 0 0 0 0 0 0 0 0 0 0 0 0 0 0 0 0 0 0 0 0 0 0 

[COLLISION]
0 0 0 0 0 0 0 0 0 0 0 0 0 0 0 0 0 0 0 0 0 0 0 0 0 0 0 0 0 0 0 0 0 0 0 0 0 0 0 0 
0 0 0 0 0 0 0 0 0 0 0 0 0 0 0 0 0 0 0 0 0 0 0 0 0 0 0 0 0 0 0 0 0 0 0 0 0 0 0 0 
0 0 0 0 0 0 0 0 0 0 0 0 0 0 0 0 0 0 0 0 0 0 6 2 2 7 0 0 0 0 0 0 0 0 0 0 0 0 0 0 
0 0 0 0 0 0 0 0 0 6 2 7 0 0 0 0 0 0 0 0 6 2 13 0 0 12 2 7 0 0 0 0 0 0 0 0 0 0 0 0 
0 0 0 0 0 0 6 2 2 13 0 12 2 7 0 0 0 0 0 6 13 0 0 0 0 0 0 12 7 0 6 2 2 7 0 0 0 0 0 0 
0 0 0 0 0 6 13 0 0 0 0 0 0 12 2 2 2 2 2 13 0 0 0 0 0 0 0 0 12 2 13 0 0 12 2 7 0 0 0 0 
0 0 0 0 0 5 0 0 0 0 0 0 0 0 0 0 0 0 0 0 0 0 10 4 4 11 0 0 0 0 0 0 0 0 0 12 7 0 0 0 
0 0 0 0 6 13 0 0 0 0 0 0 0 0 0 0 0 0 0 0 0 0 3 0 0 5 0 0 0 0 0 0 0 0 0 0 3 0 0 0 
0 0 0 0 5 0 0 0 0 0 10 4 4 11 0 0 0 0 0 0 10 4 9 0 0 8 4 11 0 0 0 0 0 0 0 0 0 1 0 0 
0 0 0 6 13 0 0 0 0 10 9 0 0 8 11 0 0 0 0 10 9 0 0 0 0 0 0 5 0 0 0 0 0 0 0 0 0 1 0 0 
0 0 0 5 0 0 0 0 0 3 0 0 0 0 8 11 0 10 4 9 0 0 0 0 0 0 0 8 11 0 0 0 0 0 0 0 3 0 0 0 
0 0 0 5 0 0 0 0 0 12 7 0 0 0 0 8 4 9 0 0 0 0 0 0 0 0 0 0 8 4 11 0 0 0 0 10 9 0 0 0 
0 0 0 8 11 0 0 0 0 0 3 0 0 0 0 0 0 6 2 2 7 0 0 0 0 0 0 0 0 0 5 0 0 10 4 9 0 0 0 0 
0 0 0 0 5 0 0 0 0 0 3 0 0 0 0 6 2 13 0 0 12 2 7 0 0 0 0 0 0 6 13 0 0 12 7 0 0 0 0 0 
0 0 0 0 8 4 11 0 0 0 12 2 2 2 2 13 0 0 0 0 0 0 12 7 0 0 0 0 0 5 0 0 0 0 12 7 0 0 0 0 
0 0 0 0 0 0 8 11 0 0 0 0 0 0 0 0 0 0 0 0 0 0 0 12 7 0 0 0 0 5 0 0 0 0 0 3 0 0 0 0 
0 0 0 0 0 6 2 13 0 0 10 4 4 4 4 11 0 0 0 0 0 0 0 10 9 0 0 0 6 13 0 0 0 0 0 3 0 0 0 0 
0 0 0 0 6 13 0 0 0 10 9 0 0 0 0 5 0 0 0 0 0 0 0 3 0 0 0 0 5 0 0 0 0 0 0 3 0 0 0 0 
0 0 0 0 5 0 0 0 0 12 7 0 0 0 0 8 4 4 11 0 0 0 10 9 0 0 0 0 8 11 0 0 0 0 0 3 0 0 0 0 
0 0 0 6 13 0 0 0 0 0 12 2 7 0 0 0 0 0 8 11 0 10 9 0 0 0 0 0 0 8 11 0 0 0 10 9 0 0 0 0 
0 0 0 5 0 0 0 0 0 0 0 0 12 2 7 0 0 0 0 8 4 9 0 0 0 0 0 0 0 0 5 0 10 4 9 0 0 0 0 0 
0 0 0 8 11 0 0 0 0 0 0 0 0 0 12 7 0 0 0 0 0 0 0 0 0 0 0 0 0 0 5 0 3 0 0 0 0 0 0 0 
0 0 0 0 8 11 0 0 0 0 0 0 0 0 0 12 7 0 0 0 0 0 0 0 0 0 0 0 0 6 13 0 3 0 0 0 0 0 0 0 
0 0 0 0 0 8 11 0 0 0 0 0 0 0 0 10 9 0 0 0 0 0 0 0 0 0 0 0 6 13 0 0 12 7 0 0 0 0 0 0 
0 0 0 0 0 0 8 4 4 11 0 0 0 0 10 9 0 0 0 0 0 0 0 0 0 0 0 0 5 0 0 0 0 3 0 0 0 0 0 0 
0 0 0 0 0 0 0 0 0 8 11 0 0 0 3 0 0 0 0 0 0 0 6 2 7 0 0 6 13 0 0 0 0 12 7 0 0 0 0 0 
0 0 0 0 0 0 0 0 0 0 5 0 0 0 12 2 7 0 0 0 0 6 13 0 12 2 2 13 0 0 0 0 0 0 12 7 0 0 0 0 
0 0 0 0 0 0 0 0 0 6 13 0 0 0 0 0 12 2 7 0 0 5 0 0 0 0 0 0 0 0 0 0 0 0 0 12 7 0 0 0 
0 0 0 0 0 0 0 6 2 13 0 0 0 0 0 0 0 0 12 2 2 13 0 0 0 0 0 0 0 0 0 0 0 0 0 0 12 7 0 0 
0 0 0 0 0 0 6 13 0 0 0 0 0 0 0 0 0 0 0 0 0 0 0 0 0 0 0 0 0 10 4 11 0 0 0 0 0 3 0 0 
0 0 0 0 0 6 13 0 0 0 0 0 0 0 0 0 0 0 0 0 0 0 0 0 0 0 0 0 0 3 0 8 11 0 0 0 10 9 0 0 
0 0 0 0 6 13 0 0 0 0 0 0 0 0 0 10 4 4 11 0 0 0 0 0 0 0 0 0 0 3 0 0 8 11 0 10 9 0 0 0 
0 0 0 0 5 0 0 0 0 0 0 0 0 10 4 9 0 0 8 11 0 0 0 0 0 0 0 0 10 9 0 0 0 8 4 9 0 0 0 0 
0 0 0 0 8 11 0 0 0 0 0 10 4 9 0 0 0 0 0 5 0 0 0 0 0 0 0 0 3 0 0 0 0 0 0 0 0 0 0 0 
0 0 0 0 0 8 11 0 0 0 10 9 0 0 0 0 0 0 0 8 4 11 0 0 0 0 0 10 9 0 0 0 0 0 0 0 0 0 0 0 
0 0 0 0 0 0 8 4 11 10 9 0 0 0 0 0 0 0 0 0 0 8 11 0 0 10 4 9 0 0 0 0 0 0 0 0 0 0 0 0 
0 0 0 0 0 0 0 0 8 9 0 0 0 0 0 0 0 0 0 0 0 0 8 0 0 9 0 0 0 0 0 0 0 0 0 0 0 0 0 0 
0 0 0 0 0 0 0 0 0 0 0 0 0 0 0 0 0 0 0 0 0 0 0 1 1 0 0 0 0 0 0 0 0 0 0 0 0 0 0 0 
0 0 0 0 0 0 0 0 0 0 0 0 0 0 0 0 0 0 0 0 0 0 0 0 0 0 0 0 0 0 0 0 0 0 0 0 0 0 0 0 
0 0 0 0 0 0 0 0 0 0 0 0 0 0 0 0 0 0 0 0 0 0 0 0 0 0 0 0 0 0 0 0 0 0 0 0 0 0 0 0 
