[TILESET]
TileSheet

[TERRAIN]
105 105 105 105 105 105 105 105 105 105 105 105 105 114 1 1 2 2 108 105 105 107 2 2 2 2 2 2 108 105 105 107 1 1 67 71 16 16 16 16 58 1 1 108 105 105 105 105 105 105 
105 105 105 104 105 105 105 105 105 105 105 105 105 105 114 106 106 115 105 105 105 107 2 2 1 1 2 2 113 105 105 105 114 2 1 59 16 16 16 69 66 2 106 108 105 105 105 105 105 105 
105 104 112 109 113 105 105 105 105 105 105 105 105 105 105 105 105 105 105 105 104 112 2 1 1 1 1 2 111 113 105 105 105 114 2 67 57 57 57 66 2 115 105 105 105 105 105 105 105 105 
112 109 110 1 106 108 105 105 104 104 104 104 104 105 105 105 105 105 105 112 109 110 1 1 2 1 1 1 2 111 113 104 105 107 106 2 2 1 1 2 2 113 105 105 105 105 105 105 104 104 
110 2 1 115 105 105 104 112 109 109 109 109 109 108 105 105 105 105 107 110 2 1 2 1 2 2 1 2 2 1 111 109 108 105 105 114 106 2 106 115 114 115 105 105 104 104 104 112 109 109 
1 1 115 105 105 107 109 110 1 2 2 1 2 113 104 104 104 104 112 2 1 1 1 1 1 106 2 2 2 2 2 2 113 105 105 105 112 2 108 105 105 105 105 112 109 109 109 110 1 2 
106 106 108 105 105 107 2 2 1 2 1 2 2 111 109 109 109 109 110 2 1 1 2 2 115 105 114 106 2 2 2 2 111 108 105 107 2 2 113 105 105 105 107 110 2 2 2 2 2 2 
105 105 105 105 105 112 2 1 1 1 1 1 1 2 2 1 2 2 2 1 1 2 2 115 105 105 105 105 114 2 2 1 2 108 105 107 2 2 115 105 105 105 107 2 2 1 1 1 1 2 
105 105 105 105 107 110 2 2 1 1 1 1 1 2 2 2 1 2 2 1 1 2 2 108 105 105 105 105 112 2 2 1 2 108 105 105 114 106 108 105 105 105 107 2 2 1 1 2 2 2 
105 105 105 105 105 114 2 2 1 1 2 1 2 2 2 115 114 106 2 2 2 2 2 113 104 104 104 112 110 2 1 1 2 108 105 105 105 105 105 105 105 105 112 2 2 1 1 2 2 2 
105 105 105 105 105 107 2 2 1 1 1 1 2 2 115 105 105 105 114 2 2 1 1 111 109 109 109 110 2 2 1 2 115 105 105 105 105 105 105 105 105 107 110 2 2 1 1 2 106 106 
105 105 105 105 104 112 106 2 2 1 2 2 106 115 105 105 105 105 105 114 2 2 2 2 9 6 6 8 2 2 2 2 108 105 105 105 105 105 105 105 104 112 2 2 1 1 2 115 105 105 
105 105 105 107 109 115 107 1 1 2 2 115 105 105 105 105 105 105 105 105 114 2 2 2 7 3 13 10 2 2 106 115 105 105 104 104 104 104 104 112 109 110 2 2 1 2 115 105 105 105 
105 105 105 105 114 108 107 1 2 65 64 113 105 105 105 105 105 105 105 105 105 114 65 64 11 12 5 2 2 115 105 105 105 112 65 56 56 56 56 64 2 2 2 1 1 2 113 105 105 105 
105 105 105 105 105 105 107 2 2 59 70 64 113 104 104 104 104 104 112 113 104 112 59 70 53 127 126 54 64 113 112 113 112 110 67 57 71 16 16 70 64 2 2 1 2 2 111 108 105 105 
105 104 105 105 105 105 112 2 2 67 71 70 64 109 109 109 65 56 56 64 1 65 68 16 23 39 39 22 70 56 56 56 64 2 1 1 59 16 16 16 58 2 1 1 2 2 2 108 105 105 
112 109 113 105 105 107 110 2 1 2 59 16 70 56 56 56 68 16 16 70 56 68 16 16 23 39 39 22 16 16 16 16 70 64 2 1 67 71 16 16 70 64 2 1 1 2 2 108 105 105 
110 1 111 108 105 105 114 2 1 2 59 16 16 16 16 16 16 16 16 16 16 16 16 16 23 39 39 22 16 16 16 16 16 70 56 64 1 59 16 16 16 58 2 2 1 2 115 105 105 105 
1 1 115 105 105 105 112 2 1 2 67 71 16 16 16 16 16 16 16 16 16 69 57 57 52 125 124 55 57 71 16 16 16 16 16 70 56 68 16 16 16 58 2 2 2 2 108 105 105 105 
2 2 108 105 105 112 110 1 1 2 2 67 57 57 71 16 16 16 16 69 57 66 2 2 2 7 5 2 2 67 57 57 71 16 16 16 16 16 16 16 69 66 2 2 1 2 113 105 105 105 
56 64 113 104 112 110 2 2 1 1 2 2 2 2 67 57 57 57 57 66 2 2 2 2 9 14 5 2 1 1 115 114 67 71 16 16 16 16 16 16 58 1 1 1 1 2 111 108 105 105 
16 70 56 56 64 2 2 2 2 1 1 2 2 2 2 2 2 2 2 2 1 1 2 2 7 13 10 1 1 2 108 105 114 67 71 16 16 16 16 69 66 2 2 1 2 2 115 105 105 104 
16 16 16 16 70 56 64 2 2 2 1 1 1 2 2 2 2 2 2 2 1 1 2 2 7 5 2 2 2 2 108 105 105 114 67 57 57 57 57 66 2 1 2 1 2 1 113 104 112 65 
16 16 16 16 16 16 70 56 64 2 1 1 2 2 65 56 64 2 2 2 2 1 1 2 11 10 2 1 1 2 108 105 105 107 2 1 1 2 2 2 2 2 2 2 2 2 65 56 56 68 
16 16 16 16 16 16 16 69 66 2 1 2 2 65 68 16 70 56 56 56 64 2 2 2 2 2 1 1 1 115 105 105 105 112 2 1 1 1 2 2 2 2 2 2 65 56 68 16 16 16 
16 16 16 16 16 16 16 58 2 2 1 2 2 59 16 16 16 16 16 16 70 64 2 2 2 2 1 1 115 105 105 105 107 110 2 2 2 2 2 2 2 2 1 65 68 16 16 16 69 57 
16 16 16 16 16 69 57 66 2 2 2 2 2 67 57 57 57 71 16 69 57 66 2 2 2 1 1 1 108 105 105 105 112 2 2 2 1 2 2 2 1 1 65 68 16 16 16 69 66 2 
16 16 69 57 57 66 2 2 2 2 2 2 2 2 2 2 2 67 57 66 2 2 2 2 1 2 2 2 113 104 104 112 110 2 2 2 2 2 1 2 1 65 68 16 16 16 69 66 1 106 
16 69 66 2 2 2 2 2 2 1 1 1 2 2 2 2 2 2 2 2 2 2 2 2 2 2 2 2 111 109 109 110 2 2 2 2 2 65 56 56 56 68 16 16 16 69 66 1 115 105 
57 66 2 2 1 2 1 1 1 2 1 1 2 2 115 114 106 2 2 2 106 106 106 106 106 2 2 2 2 2 2 2 2 1 2 1 65 68 16 16 16 16 16 16 16 58 2 115 105 105 
115 114 115 114 2 2 1 2 2 2 2 2 2 115 105 105 105 114 106 115 105 105 105 105 107 2 2 2 2 2 2 2 1 1 1 65 68 16 16 16 69 57 71 16 16 58 2 113 105 105 
105 105 105 105 114 106 2 2 2 2 2 1 115 105 105 112 113 105 105 105 104 105 105 105 112 65 56 53 42 42 42 42 54 56 56 68 16 16 16 69 66 1 67 71 16 70 64 111 113 104 
105 105 105 105 105 105 114 2 2 2 1 1 113 105 105 114 111 113 104 112 109 108 105 107 110 67 71 23 39 39 39 39 22 16 16 16 16 16 16 58 2 2 1 67 71 16 58 1 111 109 
105 105 105 105 105 105 112 2 2 2 2 2 111 108 105 107 1 111 109 110 2 108 105 107 65 56 68 23 39 39 39 39 22 16 16 16 16 16 16 70 56 64 1 1 59 16 70 56 64 2 
105 105 105 105 105 112 65 56 64 2 2 2 1 113 105 107 106 106 106 1 2 113 105 107 67 71 16 23 39 39 39 39 22 16 16 16 16 16 16 16 16 70 56 56 68 16 16 16 70 64 
105 105 105 105 112 65 68 16 70 64 2 2 1 111 113 104 105 105 105 114 2 111 113 105 114 67 71 23 39 39 39 39 22 69 57 57 57 71 16 16 16 16 16 16 16 16 16 16 16 70 
105 105 105 105 114 59 16 16 16 58 2 2 2 2 111 109 108 105 105 107 106 1 111 108 105 114 67 52 125 47 47 124 55 66 115 114 106 67 57 71 16 16 16 16 16 16 16 16 16 16 
105 105 105 105 112 59 16 16 16 58 1 1 2 2 1 1 108 105 105 105 107 106 106 108 105 107 2 2 7 3 3 5 2 2 113 104 105 114 106 67 57 71 16 16 16 16 16 16 16 16 
105 105 105 107 2 59 16 16 16 70 64 2 2 2 1 2 113 105 105 105 105 105 105 105 105 112 2 2 11 12 3 15 8 2 111 109 108 105 105 114 106 67 57 57 57 71 16 16 16 16 
105 105 105 105 114 67 71 16 16 16 58 2 1 2 1 1 111 113 104 104 104 105 105 105 107 110 1 9 6 14 3 3 5 2 2 115 107 113 104 105 107 2 2 1 2 67 71 16 16 16 
105 105 105 105 105 114 67 71 16 16 58 2 2 2 2 1 2 111 109 109 109 113 104 104 112 2 1 7 13 12 3 3 5 2 1 108 107 111 109 113 112 2 2 1 1 2 67 71 16 16 
105 105 105 105 105 105 114 67 57 57 66 115 114 2 2 1 2 2 2 65 56 64 109 109 110 2 9 14 15 14 3 13 10 1 2 113 112 1 1 111 110 1 2 2 1 1 2 59 16 16 
105 105 105 105 105 105 107 115 114 106 115 105 105 114 2 2 2 2 65 68 16 70 56 56 64 2 11 4 12 3 3 5 1 1 1 111 110 2 2 2 2 2 1 1 1 1 2 59 16 16 
105 105 105 105 105 105 105 105 105 104 112 113 105 107 2 2 2 2 49 21 21 21 21 21 51 2 1 1 11 116 116 10 2 2 2 2 2 1 2 2 2 2 2 2 2 2 2 59 16 16 
105 105 105 105 105 105 105 105 107 109 110 111 108 105 114 2 1 2 41 38 38 38 38 38 43 2 1 2 115 105 107 2 65 56 64 1 2 65 56 56 53 42 42 42 54 64 65 68 16 16 
104 105 105 104 104 105 105 105 105 114 106 115 105 105 107 106 106 2 48 20 20 20 20 20 50 2 2 2 113 105 107 65 68 16 70 56 56 68 16 16 23 39 39 39 22 70 68 16 16 16 
109 113 112 109 109 113 104 104 104 104 105 105 105 105 105 105 105 114 67 71 16 16 16 16 70 64 2 2 111 108 107 59 16 16 16 16 16 16 16 16 23 39 39 39 22 16 16 16 16 16 
2 111 110 1 1 111 109 109 109 109 113 104 104 105 105 105 105 105 114 67 71 16 16 16 69 66 2 2 1 108 112 59 16 16 16 16 16 16 16 16 23 39 39 39 22 16 16 16 16 16 
2 2 1 1 1 1 1 2 2 2 111 109 109 108 105 105 105 104 112 65 68 16 16 69 66 1 2 2 115 107 65 68 16 16 16 16 16 16 16 16 23 39 39 39 22 16 16 16 16 16 
2 2 2 2 2 2 1 1 1 1 2 2 2 108 105 105 112 109 65 68 16 16 16 70 56 64 1 2 108 107 67 71 16 16 16 16 16 16 69 57 52 40 40 40 55 71 16 16 16 16 
106 106 115 114 2 2 2 1 1 1 2 2 2 113 105 107 110 1 67 71 16 16 16 16 69 66 1 2 113 105 114 67 71 16 16 16 16 69 66 1 2 2 2 2 65 68 16 16 16 16 
105 105 105 105 114 1 1 1 2 1 1 1 2 111 113 112 2 65 56 68 16 16 69 57 66 1 1 2 111 113 112 2 67 57 57 57 57 66 2 1 1 1 2 1 59 16 16 16 16 16 
105 105 105 105 107 1 1 1 1 1 2 2 1 2 111 110 2 49 21 21 21 21 51 2 1 1 1 2 2 111 110 2 1 1 2 2 2 2 2 1 1 1 2 65 68 16 16 16 16 16 
105 105 105 105 112 2 2 1 1 2 2 106 1 1 2 2 2 41 38 38 38 38 43 2 1 1 1 2 2 2 2 2 1 1 1 1 2 1 1 2 2 2 2 67 57 71 16 16 16 16 
105 105 105 107 110 2 1 1 2 2 115 105 114 106 106 115 114 48 20 20 20 20 50 2 2 106 106 106 115 114 2 1 2 2 2 2 106 106 2 2 106 106 106 115 114 67 71 16 16 16 
105 105 105 107 2 2 2 2 2 115 105 105 105 105 105 104 112 59 16 16 16 16 70 64 115 105 105 105 105 105 114 106 106 106 106 115 105 105 114 115 105 105 105 105 112 2 67 71 16 16 
105 105 105 105 114 115 114 106 115 105 105 105 105 105 112 109 110 59 16 16 16 16 16 58 113 105 105 105 105 105 105 105 105 105 105 105 105 105 105 105 105 105 105 105 114 106 2 67 57 57 
105 105 105 105 105 105 105 105 105 105 105 105 104 112 110 65 56 68 16 16 16 16 16 70 64 113 112 113 105 105 105 105 105 105 105 105 105 105 105 104 104 105 105 105 105 105 114 115 114 106 
105 105 105 105 105 105 105 105 105 105 105 112 109 110 1 59 16 16 16 16 16 16 16 16 70 56 64 111 113 105 105 105 105 105 105 105 105 104 112 109 109 113 105 105 105 105 105 105 105 105 
105 105 105 105 105 105 105 105 105 105 112 110 1 1 1 67 71 16 16 16 16 16 16 16 16 69 66 1 115 105 105 105 105 105 105 105 107 109 110 2 2 111 108 105 105 105 105 105 105 105 

[COLLISION]
0 0 0 0 0 0 0 0 0 0 0 0 0 0 0 0 0 0 0 0 0 1 0 0 0 0 0 0 1 0 0 0 0 0 0 0 0 0 0 0 0 0 0 0 0 0 0 0 0 0 
0 0 0 0 0 0 0 0 0 0 0 0 0 0 0 0 0 0 0 0 0 1 0 0 0 0 0 0 7 0 0 0 0 0 0 0 0 0 0 0 0 0 0 0 0 0 0 0 0 0 
0 0 0 0 0 0 0 0 0 0 0 0 0 0 0 0 0 0 0 0 1 6 0 0 0 0 0 0 0 7 0 0 0 0 0 0 0 0 0 0 0 0 0 0 0 0 0 0 0 0 
0 0 0 0 0 0 0 0 1 1 1 1 1 0 0 0 0 0 0 6 0 0 0 0 0 0 0 0 0 0 7 1 0 0 0 0 0 0 0 0 0 0 0 0 0 0 0 0 1 1 
0 0 0 0 0 0 1 6 0 0 0 0 0 1 0 0 0 0 1 0 0 0 0 0 0 0 0 0 0 0 0 0 1 0 0 0 0 0 0 0 0 0 0 0 1 1 1 6 0 0 
0 0 0 0 0 1 0 0 0 0 0 0 0 7 1 1 1 1 6 0 0 0 0 0 0 4 0 0 0 0 0 0 7 0 0 0 0 0 0 0 0 0 0 6 0 0 0 0 0 0 
0 0 0 0 0 1 0 0 0 0 0 0 0 0 0 0 0 0 0 0 0 0 0 0 9 0 8 4 0 0 0 0 0 1 0 0 0 0 0 0 0 0 1 0 0 0 0 0 0 0 
0 0 0 0 0 6 0 0 0 0 0 0 0 0 0 0 0 0 0 0 0 0 0 9 0 0 0 0 8 0 0 0 0 1 0 0 0 0 0 0 0 0 1 0 0 0 0 0 0 0 
0 0 0 0 1 0 0 0 0 0 0 0 0 0 0 0 0 0 0 0 0 0 0 1 0 0 0 0 6 0 0 0 0 1 0 0 0 0 0 0 0 0 1 0 0 0 0 0 0 0 
0 0 0 0 0 8 0 0 0 0 0 0 0 0 0 9 8 4 0 0 0 0 0 7 1 1 1 6 0 0 0 0 0 1 0 0 0 0 0 0 0 0 6 0 0 0 0 0 0 0 
0 0 0 0 0 1 0 0 0 0 0 0 0 0 9 0 0 0 8 0 0 0 0 0 0 0 0 0 0 0 0 0 9 0 0 0 0 0 0 0 0 1 0 0 0 0 0 0 4 4 
0 0 0 0 0 1 4 0 0 0 0 0 4 9 0 0 0 0 0 8 0 0 0 0 0 0 0 0 0 0 0 0 1 0 0 0 0 0 0 0 1 6 0 0 0 0 0 9 0 0 
0 0 0 0 0 0 1 0 0 0 0 9 0 0 0 0 0 0 0 0 8 0 0 0 0 0 0 0 0 0 4 9 0 0 0 0 0 0 0 6 0 0 0 0 0 0 9 0 0 0 
0 0 0 0 0 0 1 0 0 10 4 5 0 0 0 0 0 0 0 0 0 8 4 11 0 0 0 0 0 9 0 0 0 0 0 0 0 0 0 5 0 0 0 0 0 0 7 0 0 0 
0 0 0 0 0 0 1 0 0 3 0 0 0 0 0 0 0 0 0 0 0 0 0 8 11 0 0 10 4 5 0 0 0 0 0 0 0 0 0 8 11 0 0 0 0 0 0 1 0 0 
0 0 0 0 0 0 6 0 0 12 7 0 0 0 0 0 0 0 0 0 0 0 0 0 5 0 0 3 0 0 0 0 0 0 0 0 0 0 0 0 5 0 0 0 0 0 0 1 0 0 
0 0 0 0 0 1 0 0 0 0 3 0 0 0 0 0 0 0 0 0 0 0 0 0 5 0 0 3 0 0 0 0 0 0 0 0 0 0 0 0 8 11 0 0 0 0 0 1 0 0 
0 0 0 0 0 0 8 0 0 0 3 0 0 0 0 0 0 0 0 0 0 0 0 0 5 0 0 3 0 0 0 0 0 0 0 0 0 0 0 0 0 5 0 0 0 0 9 0 0 0 
0 0 0 0 0 0 6 0 0 0 12 7 0 0 0 0 0 0 0 0 0 6 2 2 13 0 0 12 2 7 0 0 0 0 0 0 0 0 0 0 0 5 0 0 0 0 1 0 0 0 
0 0 0 0 0 6 0 0 0 0 0 12 2 2 7 0 0 0 0 6 2 13 0 0 0 0 0 0 0 12 7 0 0 0 0 0 0 0 0 0 6 13 0 0 0 0 7 0 0 0 
0 0 0 0 6 0 0 0 0 0 0 0 0 0 12 2 2 2 2 13 0 0 0 0 0 0 0 0 0 0 9 0 0 0 0 0 0 0 0 0 5 0 0 0 0 0 0 1 0 0 
0 0 0 0 5 0 0 0 0 0 0 0 0 0 0 0 0 0 0 0 0 0 0 0 0 0 0 0 0 0 1 0 0 0 0 0 0 0 0 6 13 0 0 0 0 0 9 0 0 0 
0 0 0 0 8 4 11 0 0 0 0 0 0 0 0 0 0 0 0 0 0 0 0 0 0 0 0 0 0 0 1 0 0 3 2 2 2 2 2 13 0 0 0 0 0 0 7 0 0 0 
0 0 0 0 0 0 8 4 11 0 0 0 0 0 10 4 11 0 0 0 0 0 0 0 0 0 0 0 0 0 1 0 0 1 0 0 0 0 0 0 0 0 0 0 0 0 3 0 0 0 
0 0 0 0 0 0 0 6 13 0 0 0 0 10 9 0 8 4 4 4 11 0 0 0 0 0 0 0 0 9 0 0 0 6 0 0 0 0 0 0 0 0 0 0 10 4 9 0 0 0 
0 0 0 0 0 0 0 5 0 0 0 0 0 3 0 0 0 0 0 0 8 11 0 0 0 0 0 0 9 0 0 0 1 0 0 0 0 0 0 0 0 0 0 10 9 0 0 0 0 0 
0 0 0 0 0 6 2 13 0 0 0 0 0 12 2 2 2 7 0 6 2 13 0 0 0 0 0 0 1 0 0 0 6 0 0 0 0 0 0 0 0 0 10 9 0 0 0 0 0 0 
0 0 6 2 2 13 0 0 0 0 0 0 0 0 0 0 0 12 2 13 0 0 0 0 0 0 0 0 7 1 1 6 0 0 0 0 0 0 0 0 0 10 9 0 0 0 0 0 0 0 
0 6 13 0 0 0 0 0 0 0 0 0 0 0 0 0 0 0 0 0 0 0 0 0 0 0 0 0 0 0 0 0 0 0 0 0 0 10 4 4 4 9 0 0 0 0 0 0 0 0 
0 5 0 0 0 0 0 0 0 0 0 0 0 0 9 8 4 0 0 0 4 4 4 4 4 0 0 0 0 0 0 0 0 0 0 0 10 9 0 0 0 0 0 0 0 0 0 0 0 0 
0 8 9 8 0 0 0 0 0 0 0 0 0 9 0 0 0 8 4 9 0 0 0 0 1 0 0 0 0 0 0 0 0 0 0 10 9 0 0 0 0 0 0 0 0 0 0 0 0 0 
0 0 0 0 8 4 0 0 0 0 0 0 9 0 0 0 0 0 0 0 0 0 0 0 1 4 4 11 0 0 0 0 10 4 4 9 0 0 0 0 0 0 0 0 0 0 0 0 0 0 
0 0 0 0 0 0 8 0 0 0 0 0 7 0 0 0 0 0 0 0 0 0 0 0 0 0 0 5 0 0 0 0 3 0 0 0 0 0 0 0 0 0 0 0 0 0 0 0 0 0 
0 0 0 0 0 0 6 0 0 0 0 0 0 1 0 0 0 0 0 0 0 0 0 0 0 0 0 5 0 0 0 0 3 0 0 0 0 0 0 0 0 0 0 0 0 0 0 0 0 0 
0 0 0 0 0 0 8 4 11 0 0 0 0 7 0 0 0 0 0 0 0 0 0 0 0 0 0 5 0 0 0 0 3 0 0 0 0 0 0 0 0 0 0 0 0 0 0 0 0 0 
0 0 0 0 0 0 0 0 8 11 0 0 0 0 7 1 0 0 0 0 0 0 0 0 0 0 0 5 0 0 0 0 3 0 0 0 0 0 0 0 0 0 0 0 0 0 0 0 0 0 
0 0 0 0 0 0 0 0 0 5 0 0 0 0 0 0 1 0 0 0 0 0 0 0 0 1 2 13 0 0 0 0 12 2 5 0 0 0 0 0 0 0 0 0 0 0 0 0 0 0 
0 0 0 0 0 0 0 0 0 5 0 0 0 0 0 0 1 0 0 0 0 0 0 0 0 1 0 0 0 0 0 0 0 0 7 1 0 0 0 0 0 0 0 0 0 0 0 0 0 0 
0 0 0 0 0 0 0 0 0 8 11 0 0 0 0 0 7 0 0 0 0 0 0 0 0 6 0 0 0 0 0 0 0 0 0 0 1 0 0 0 3 2 2 2 2 7 0 0 0 0 
0 0 0 0 0 0 0 0 0 0 5 0 0 0 0 0 0 7 1 1 1 0 0 0 1 0 0 0 0 0 0 0 0 0 0 9 1 1 1 0 1 0 0 0 0 12 7 0 0 0 
0 0 0 0 0 0 0 0 0 0 5 0 0 0 0 0 0 0 0 0 0 7 1 1 6 0 0 0 0 0 0 0 0 0 0 1 1 0 0 7 6 0 0 0 0 0 12 7 0 0 
0 0 0 0 0 0 0 0 0 0 5 9 8 0 0 0 0 0 0 10 4 11 0 0 0 0 0 0 0 0 0 0 0 0 0 7 6 0 0 0 0 0 0 0 0 0 0 3 0 0 
0 0 0 0 0 0 0 0 0 0 1 0 0 8 0 0 0 0 10 9 0 8 4 4 11 0 0 0 0 0 0 0 0 0 0 0 0 0 0 0 0 0 0 0 0 0 0 3 0 0 
0 0 0 0 0 0 0 0 0 0 0 0 0 1 0 0 0 0 12 2 2 2 2 2 13 0 0 0 0 4 4 0 0 0 0 0 0 0 0 0 0 0 0 0 0 0 0 3 0 0 
0 0 0 0 0 0 0 0 0 0 0 0 0 0 8 0 0 0 0 0 0 0 0 0 0 0 0 0 9 0 1 0 10 4 11 0 0 10 4 4 11 0 0 0 10 11 10 9 0 0 
1 0 0 1 1 0 0 0 0 0 0 0 0 0 1 4 4 0 10 4 4 4 4 4 11 0 0 0 7 0 1 4 9 0 8 4 4 9 0 0 5 0 0 0 3 8 9 0 0 0 
0 7 6 0 0 7 1 1 1 1 0 0 0 0 0 0 0 8 9 0 0 0 0 0 8 11 0 0 0 1 0 0 0 0 0 0 0 0 0 0 5 0 0 0 3 0 0 0 0 0 
0 0 0 0 0 0 0 0 0 0 7 1 1 0 0 0 0 0 0 0 0 0 0 0 6 13 0 0 0 1 0 0 0 0 0 0 0 0 0 0 5 0 0 0 3 0 0 0 0 0 
0 0 0 0 0 0 0 0 0 0 0 0 0 1 0 0 0 1 1 0 0 0 0 6 13 0 0 0 9 0 0 0 0 0 0 0 0 0 0 0 5 0 0 0 3 0 0 0 0 0 
0 0 0 0 0 0 0 0 0 0 0 0 0 1 0 0 6 0 3 0 0 0 0 8 4 11 0 0 1 0 0 0 0 0 0 0 0 0 6 2 13 0 0 0 12 7 0 0 0 0 
4 4 9 8 0 0 0 0 0 0 0 0 0 7 0 1 0 0 12 7 0 0 0 0 6 13 0 0 7 0 3 2 7 0 0 0 0 6 13 0 0 0 0 0 10 9 0 0 0 0 
0 0 0 0 8 0 0 0 0 0 0 0 0 0 7 6 0 10 4 9 0 0 6 2 13 0 0 0 0 7 6 0 12 2 2 2 2 13 0 0 0 0 0 0 3 0 0 0 0 0 
0 0 0 0 1 0 0 0 0 0 0 0 0 0 0 0 0 12 2 2 2 2 13 0 0 0 0 0 0 0 0 0 0 0 0 0 0 0 0 0 0 0 0 10 9 0 0 0 0 0 
0 0 0 0 6 0 0 0 0 0 0 4 0 0 0 0 0 0 0 0 0 0 0 0 0 0 0 0 0 0 0 0 0 0 0 0 0 0 0 0 0 0 0 3 0 0 0 0 0 0 
0 0 0 1 0 0 0 0 0 0 9 0 8 4 4 9 8 4 4 4 4 4 11 0 0 4 4 4 9 8 0 0 0 0 0 0 4 4 0 0 4 4 4 9 0 0 0 0 0 0 
0 0 0 1 0 0 0 0 0 9 0 0 0 0 0 0 0 0 0 0 0 0 8 4 9 0 0 0 0 0 8 4 4 4 4 9 0 0 8 9 0 0 0 0 0 0 0 0 0 0 
0 0 0 0 8 9 8 4 9 0 0 0 0 0 0 0 0 0 0 0 0 0 0 0 0 0 0 0 0 0 0 0 0 0 0 0 0 0 0 0 0 0 0 0 0 0 0 0 0 0 
0 0 0 0 0 0 0 0 0 0 0 0 0 0 0 0 0 0 0 0 0 0 0 0 0 0 0 0 0 0 0 0 0 0 0 0 0 0 0 0 0 0 0 0 0 0 0 0 0 0 
0 0 0 0 0 0 0 0 0 0 0 0 0 0 0 0 0 0 0 0 0 0 0 0 0 0 0 0 0 0 0 0 0 0 0 0 0 0 0 0 0 0 0 0 0 0 0 0 0 0 
0 0 0 0 0 0 0 0 0 0 0 0 0 0 0 0 0 0 0 0 0 0 0 0 0 0 0 0 0 0 0 0 0 0 0 0 0 0 0 0 0 0 0 0 0 0 0 0 0 0 
