[TILESET]
TileSheet

[TERRAIN]
105 105 105 105 105 104 112 2 2 59 16 58 113 105 105 105 105 105 105 105 105 105 105 105 105 105 114 2 2 2 2 108 105 105 105 105 105 105 105 105 
105 105 105 104 112 109 110 65 56 68 16 58 111 108 105 105 105 105 105 105 105 105 105 105 105 105 112 2 1 2 2 108 105 105 105 105 105 105 105 105 
105 104 112 109 110 65 56 68 16 16 69 66 115 105 105 105 105 105 105 105 104 112 113 105 105 107 110 2 1 2 2 113 105 105 105 105 105 105 105 105 
107 109 110 65 56 68 16 16 16 16 58 115 105 105 105 105 105 105 105 107 109 110 2 113 105 112 2 2 1 1 2 111 108 105 105 105 105 105 105 105 
112 65 56 68 16 16 16 16 16 69 66 113 104 104 105 105 105 105 105 105 114 106 106 115 112 110 2 2 2 1 2 115 105 105 105 105 105 105 105 105 
110 59 16 16 16 16 16 69 57 66 2 111 109 109 113 104 104 105 105 105 105 105 105 107 110 2 2 2 2 2 1 108 105 105 105 105 105 105 105 105 
65 68 16 16 16 16 69 66 2 2 2 1 2 2 111 109 109 113 105 105 105 105 105 112 2 2 1 1 2 2 2 108 105 105 105 105 105 105 105 105 
59 16 16 16 16 69 66 9 8 2 9 6 8 2 2 1 2 111 113 105 105 105 112 2 2 2 1 1 2 2 115 105 105 105 105 105 105 105 105 105 
68 16 16 16 69 66 2 7 5 9 14 13 10 2 9 8 1 1 111 113 104 112 110 2 2 2 2 2 2 2 108 105 105 105 105 105 105 105 105 105 
16 16 16 69 66 9 8 11 10 11 4 10 106 2 11 10 2 9 8 111 109 110 2 2 2 1 1 2 2 2 113 105 105 105 105 105 105 105 105 105 
57 71 16 58 2 7 15 6 8 2 2 115 105 114 106 2 2 7 15 6 8 2 2 9 6 8 2 2 1 2 111 108 105 105 105 105 105 105 105 105 
106 67 57 66 2 7 13 12 5 2 115 105 105 105 105 114 2 11 12 3 5 2 9 14 3 15 8 2 2 2 2 113 105 105 105 105 105 105 105 105 
105 114 115 114 2 7 5 11 10 2 108 105 105 105 105 105 114 2 7 13 10 9 14 13 4 12 15 8 2 2 2 111 108 105 105 105 105 105 105 105 
105 105 105 107 2 11 10 2 2 2 113 105 105 105 105 105 107 2 11 10 1 7 3 5 1 7 3 5 2 2 2 1 108 105 105 105 105 105 105 105 
105 105 105 105 114 2 2 2 2 2 111 108 105 105 105 105 107 2 2 2 1 11 12 5 9 14 13 10 1 2 2 2 108 105 105 105 105 105 104 104 
105 105 105 105 107 2 2 1 1 2 2 113 105 105 104 104 112 2 2 2 2 2 7 15 14 3 5 1 1 2 2 115 105 105 105 104 104 112 109 109 
104 105 105 105 105 114 2 2 9 8 1 111 113 112 109 109 65 64 2 2 2 2 11 12 13 4 10 2 2 2 115 105 105 105 107 109 109 110 1 2 
109 113 105 105 105 107 2 2 11 10 2 2 111 110 65 56 68 58 2 2 2 2 1 11 10 2 2 2 2 115 105 105 105 105 105 114 106 106 2 1 
2 115 105 105 105 105 114 2 2 2 9 8 2 65 68 16 16 70 56 64 2 2 2 2 2 2 2 65 64 113 105 105 105 105 105 105 105 105 114 106 
2 113 112 113 105 105 105 114 2 2 7 15 8 59 16 16 69 71 16 70 56 64 2 2 2 65 56 68 58 111 113 105 105 105 105 105 105 105 105 105 
2 111 110 111 108 105 105 107 2 2 11 12 5 59 16 16 58 67 71 16 16 70 56 56 56 68 16 16 70 64 111 113 104 105 105 105 105 105 105 105 
2 2 106 115 105 105 105 112 2 2 1 11 10 59 16 16 70 56 68 16 16 16 16 16 16 16 16 16 16 70 56 64 109 113 105 105 104 104 105 105 
106 115 105 105 105 105 107 110 2 2 2 2 2 59 16 69 71 16 16 16 16 16 16 16 16 16 16 16 16 16 16 70 64 111 113 112 109 109 113 112 
105 105 105 105 105 105 112 2 2 1 2 2 65 68 16 58 59 16 16 16 16 16 16 16 16 16 16 69 57 57 57 57 66 2 111 110 1 2 111 110 
105 105 105 105 105 107 110 2 2 2 2 2 59 16 16 70 68 16 69 71 16 16 16 16 69 57 57 66 2 2 2 1 2 2 1 1 2 2 2 2 
105 105 105 105 105 107 2 2 1 1 2 2 67 71 16 16 16 16 70 68 16 69 57 57 66 2 1 2 2 1 1 2 2 1 1 2 2 2 1 2 
105 105 105 105 105 112 2 2 2 2 2 115 114 67 57 71 16 16 16 16 69 66 1 2 2 1 2 1 2 1 1 1 1 2 1 1 2 2 1 2 
105 105 105 105 107 2 2 2 2 2 2 108 107 2 2 67 57 57 71 69 66 2 1 2 1 2 1 2 1 2 2 1 1 1 1 2 115 114 106 106 
104 105 105 105 107 2 1 1 2 2 115 105 107 2 2 106 115 114 67 66 1 2 2 2 2 1 2 1 2 65 56 64 2 1 2 2 108 105 105 105 
109 113 105 105 107 2 2 1 2 2 113 105 105 114 115 105 105 112 2 2 1 2 2 1 1 1 2 65 56 68 16 70 64 1 1 115 105 105 105 105 
1 111 113 105 105 114 2 2 2 1 111 108 105 105 105 104 112 110 2 2 2 1 1 2 2 65 56 68 16 16 16 16 58 1 2 113 105 105 105 105 
1 1 111 108 105 105 114 2 2 1 2 113 104 104 112 109 110 1 1 1 2 2 1 1 65 68 16 16 16 16 16 16 58 2 1 111 108 105 105 105 
2 1 1 108 105 105 107 2 2 1 2 111 109 109 110 2 2 1 1 1 1 2 2 2 67 57 57 71 16 16 16 69 66 1 1 2 108 105 105 105 
114 2 2 113 105 105 105 114 2 2 2 2 2 2 2 2 2 2 2 1 1 2 106 2 1 2 1 67 57 57 57 66 1 1 2 115 105 105 105 105 
107 2 2 111 113 105 105 105 114 2 2 1 2 2 2 2 2 2 2 2 106 115 105 114 2 1 1 1 2 1 2 1 2 2 2 108 105 105 105 105 
105 114 2 2 111 108 105 105 105 114 106 2 2 2 1 2 1 2 2 115 105 105 105 105 114 106 106 106 2 1 1 1 2 106 115 105 105 105 105 105 
105 105 114 1 2 108 105 105 105 105 105 114 106 106 106 106 106 106 115 105 105 105 105 105 105 105 105 105 114 106 106 106 115 105 105 105 105 105 105 105 
105 105 112 1 2 108 105 105 105 105 105 105 105 105 105 105 105 105 105 105 105 105 105 105 105 105 105 105 105 105 105 105 105 105 105 105 105 105 105 105 
105 107 110 2 2 108 105 105 105 105 105 105 105 105 105 105 105 105 105 105 105 105 105 105 105 105 105 105 105 105 105 105 105 105 105 105 105 105 105 105 
105 107 2 2 115 105 105 105 105 105 105 105 105 105 105 105 105 105 105 105 105 105 105 105 105 105 105 105 105 105 105 105 105 105 105 105 105 105 105 105 

[COLLISION]
0 0 0 0 0 0 0 0 0 0 0 0 0 0 0 0 0 0 0 0 0 0 0 0 0 0 8 0 0 0 0 1 0 0 0 0 0 0 0 0 
0 0 0 0 0 0 0 0 0 0 0 0 0 0 0 0 0 0 0 0 0 0 0 0 0 0 6 0 0 0 0 1 0 0 0 0 0 0 0 0 
0 0 0 0 0 0 0 0 0 0 0 0 0 0 0 0 0 0 0 0 0 0 0 0 0 1 0 0 0 0 0 7 0 0 0 0 0 0 0 0 
0 0 0 0 0 0 0 0 0 0 0 0 0 0 0 0 0 0 0 0 0 0 0 0 0 6 0 0 0 0 0 0 1 0 0 0 0 0 0 0 
0 0 0 0 0 0 0 0 0 6 2 7 1 1 0 0 0 0 0 0 0 0 0 0 6 0 0 0 0 0 0 9 0 0 0 0 0 0 0 0 
0 0 0 0 0 0 0 6 2 13 0 0 0 0 7 1 1 0 0 0 0 0 0 1 0 0 0 0 0 0 0 1 0 0 0 0 0 0 0 0 
0 0 0 0 0 0 6 13 0 0 0 0 0 0 0 0 0 7 0 0 0 0 0 6 0 0 0 0 0 0 0 1 0 0 0 0 0 0 0 0 
0 0 0 0 0 6 13 0 0 0 0 0 0 0 0 0 0 0 7 0 0 0 6 0 0 0 0 0 0 0 9 0 0 0 0 0 0 0 0 0 
0 0 0 0 6 13 0 0 0 0 0 0 0 0 0 0 0 0 0 7 1 6 0 0 0 0 0 0 0 0 1 0 0 0 0 0 0 0 0 0 
0 0 0 6 13 0 0 0 0 0 0 0 4 0 0 0 0 0 0 0 0 0 0 0 0 0 0 0 0 0 7 0 0 0 0 0 0 0 0 0 
0 0 0 5 0 0 0 0 0 0 0 9 0 8 4 0 0 0 0 0 0 0 0 0 0 0 0 0 0 0 0 1 0 0 0 0 0 0 0 0 
0 0 0 5 0 0 0 0 0 0 9 0 0 0 0 8 0 0 0 0 0 0 0 0 0 0 0 0 0 0 0 7 0 0 0 0 0 0 0 0 
0 0 0 8 0 0 0 0 0 0 1 0 0 0 0 0 8 0 0 0 0 0 0 0 0 0 0 0 0 0 0 0 1 0 0 0 0 0 0 0 
0 0 0 1 0 0 0 0 0 0 7 0 0 0 0 0 1 0 0 0 0 0 0 0 0 0 0 0 0 0 0 0 1 0 0 0 0 0 0 0 
0 0 0 0 8 0 0 0 0 0 0 1 0 0 0 0 1 0 0 0 0 0 0 0 0 0 0 0 0 0 0 0 1 0 0 0 0 0 0 0 
0 0 0 0 1 0 0 0 0 0 0 7 0 0 1 1 6 0 0 0 0 0 0 0 0 0 0 0 0 0 0 9 0 0 0 0 0 0 0 0 
0 0 0 0 0 8 0 0 0 0 0 0 7 6 0 0 10 11 0 0 0 0 0 0 0 0 0 0 0 0 9 0 0 0 0 0 0 0 0 0 
0 0 0 0 0 1 0 0 0 0 0 0 0 0 10 4 9 5 0 0 0 0 0 0 0 0 0 0 0 9 0 0 0 0 0 0 0 0 0 0 
0 0 0 0 0 0 8 0 0 0 0 0 0 10 9 0 0 8 4 11 0 0 0 0 0 0 0 10 4 5 0 0 0 0 0 0 0 0 0 0 
0 0 0 0 0 0 0 8 0 0 0 0 0 3 0 0 0 0 0 8 4 11 0 0 0 10 4 9 0 0 0 0 0 0 0 0 0 0 0 0 
0 0 0 0 0 0 0 1 0 0 0 0 0 3 0 0 0 0 0 0 0 8 4 4 4 9 0 0 0 0 0 4 1 0 0 0 0 0 0 0 
0 0 0 0 0 0 0 6 0 0 0 0 0 3 0 0 0 0 0 0 0 0 0 0 0 0 0 0 0 0 0 5 0 7 0 0 1 1 0 0 
0 0 0 0 0 0 1 0 0 0 0 0 0 3 0 0 0 0 0 0 0 0 0 0 0 0 0 0 0 0 0 8 11 0 7 6 0 0 7 6 
0 0 0 0 0 0 6 0 0 0 0 0 10 9 0 0 0 0 0 0 0 0 0 0 0 0 0 6 2 2 2 2 13 0 0 0 0 0 0 0 
0 0 0 0 0 1 0 0 0 0 0 0 3 0 0 0 0 0 0 0 0 0 0 0 6 2 2 13 0 0 0 0 0 0 0 0 0 0 0 0 
0 0 0 0 0 1 0 0 0 0 0 0 3 0 0 0 0 0 0 0 0 6 2 2 13 0 0 0 0 0 0 0 0 0 0 0 0 0 0 0 
0 0 0 0 0 6 0 0 0 0 0 9 2 0 0 0 0 0 0 0 6 13 0 0 0 0 0 0 0 0 0 0 0 0 0 0 0 0 0 0 
0 0 0 0 1 0 0 0 0 0 0 1 0 0 0 0 0 0 0 6 13 0 0 0 0 0 0 0 0 0 0 0 0 0 0 0 9 8 4 4 
0 0 0 0 1 0 0 0 0 0 9 0 0 0 0 0 0 3 2 13 0 0 0 0 0 0 0 0 0 10 4 11 0 0 0 0 1 0 0 0 
0 0 0 0 1 0 0 0 0 0 7 0 0 0 0 0 0 6 0 0 0 0 0 0 0 0 0 10 4 9 0 8 11 0 0 9 0 0 0 0 
0 0 0 0 0 8 0 0 0 0 0 1 0 0 0 1 6 0 0 0 0 0 0 0 0 10 4 9 0 0 0 0 5 0 0 7 0 0 0 0 
0 0 0 0 0 0 8 0 0 0 0 7 1 1 6 0 0 0 0 0 0 0 0 0 10 9 0 0 0 0 0 0 5 0 0 0 1 0 0 0 
0 0 0 0 0 0 1 0 0 0 0 0 0 0 0 0 0 0 0 0 0 0 0 0 12 2 2 7 0 0 0 6 13 0 0 0 1 0 0 0 
0 0 0 0 0 0 0 8 0 0 0 0 0 0 0 0 0 0 0 0 0 0 4 0 0 0 0 12 2 2 2 13 0 0 0 9 0 0 0 0 
0 0 0 0 0 0 0 0 8 0 0 0 0 0 0 0 0 0 0 0 4 9 0 8 0 0 0 0 0 0 0 0 0 0 0 1 0 0 0 0 
0 0 0 0 0 0 0 0 0 8 4 0 0 0 0 0 0 0 0 9 0 0 0 0 8 4 4 4 0 0 0 0 0 4 9 0 0 0 0 0 
0 0 0 0 0 0 0 0 0 0 0 8 4 4 4 4 4 4 9 0 0 0 0 0 0 0 0 0 8 4 4 4 9 0 0 0 0 0 0 0 
0 0 0 0 0 0 0 0 0 0 0 0 0 0 0 0 0 0 0 0 0 0 0 0 0 0 0 0 0 0 0 0 0 0 0 0 0 0 0 0 
0 0 0 0 0 0 0 0 0 0 0 0 0 0 0 0 0 0 0 0 0 0 0 0 0 0 0 0 0 0 0 0 0 0 0 0 0 0 0 0 
0 0 0 0 0 0 0 0 0 0 0 0 0 0 0 0 0 0 0 0 0 0 0 0 0 0 0 0 0 0 0 0 0 0 0 0 0 0 0 0 
