[TILESET]
TileSheet

[TERRAIN]
105 105 105 105 105 105 105 107 59 70 64 2 1 59 70 64 59 69 66 115 105 105 107 2 1 2 2 2 1 1 2 106 115 105 105 105 105 105 105 105 105 105 105 105 105 105 105 107 59 70 64 2 1 65 68 16 58 2 1 67 
105 105 105 105 105 105 105 107 67 71 70 64 65 68 16 70 68 58 115 105 105 105 105 114 2 2 1 2 2 106 115 105 105 105 105 105 105 105 105 105 105 105 105 105 104 104 104 112 59 16 70 56 56 68 16 16 70 56 64 2 
105 105 105 105 105 105 105 105 114 59 16 70 68 69 57 71 69 66 108 105 105 105 105 107 2 1 2 2 115 105 105 105 105 105 105 105 105 105 105 105 105 104 104 112 109 109 109 110 67 57 71 16 16 69 57 71 16 16 70 56 
105 105 105 105 105 105 105 105 107 67 71 16 16 58 2 67 66 2 108 105 105 105 105 112 2 2 2 1 113 105 105 105 105 105 105 105 105 104 104 104 112 109 109 110 1 2 1 2 2 2 67 71 16 70 64 67 57 71 16 69 
105 105 105 105 105 105 105 105 105 114 59 16 16 58 1 2 65 64 108 105 105 105 105 114 2 1 1 2 111 108 105 105 105 105 104 104 112 109 109 109 110 1 9 8 2 9 6 8 1 2 2 67 71 16 70 64 65 68 69 66 
105 105 105 105 105 105 105 105 105 107 59 16 16 70 64 65 68 58 108 105 105 105 105 105 114 106 106 106 115 105 105 104 104 112 109 109 110 9 8 2 9 8 11 10 9 14 3 15 8 1 2 2 67 71 16 70 68 16 58 1 
105 105 105 105 105 105 105 105 105 107 59 16 69 71 70 68 16 58 108 105 105 105 105 105 105 105 105 105 105 105 112 109 109 110 2 1 2 11 10 1 7 15 8 9 14 13 4 12 5 2 1 9 8 59 16 16 16 16 58 2 
105 105 105 105 105 105 105 105 105 112 67 71 70 68 16 69 57 66 113 105 105 105 105 105 105 105 105 105 105 112 110 1 2 2 1 2 2 1 2 106 11 4 10 11 12 15 8 7 15 6 8 11 10 67 71 16 16 16 70 64 
105 105 105 105 105 105 105 104 112 110 1 49 21 21 21 51 1 2 111 113 105 105 104 104 105 105 105 105 112 110 2 2 2 1 2 1 106 106 115 105 114 2 1 2 7 3 15 14 3 3 5 1 2 106 67 57 71 16 16 70 
105 105 105 105 105 105 107 109 110 1 2 41 38 38 38 43 2 1 2 111 113 112 109 109 113 104 105 107 110 1 2 1 2 1 2 115 105 105 105 105 105 114 2 1 11 4 12 3 3 13 10 2 115 105 114 106 67 71 16 16 
105 105 105 105 105 105 112 2 2 2 2 41 38 38 38 43 2 1 1 2 111 110 2 1 111 109 113 112 1 2 2 2 2 106 115 105 105 105 105 105 105 107 106 2 1 2 11 4 4 10 2 2 108 105 105 105 114 67 57 57 
105 105 105 105 105 107 110 1 2 1 2 48 20 20 20 50 1 2 2 2 1 1 2 1 1 2 111 110 2 2 1 2 115 105 105 104 104 104 105 105 105 105 105 114 2 2 9 6 8 2 2 115 105 105 105 105 105 114 106 106 
105 105 105 105 105 112 1 2 2 2 1 59 16 16 16 70 64 1 2 1 2 1 1 65 64 2 2 1 1 2 2 2 108 105 112 109 109 109 113 104 105 105 105 105 114 2 7 13 10 2 115 105 105 105 105 105 105 105 105 105 
105 105 105 105 107 110 1 2 1 2 65 68 69 71 16 69 66 115 114 2 2 1 65 68 70 56 64 1 2 2 1 2 108 105 114 106 1 1 111 109 108 105 105 105 107 2 11 10 1 2 108 105 105 105 105 105 105 105 105 105 
105 105 105 105 107 2 2 2 1 2 67 71 70 68 69 66 115 105 107 2 1 1 67 71 16 16 70 56 64 2 2 2 113 105 105 105 114 2 1 1 108 105 105 105 112 2 2 9 8 2 113 105 105 105 105 105 105 105 105 105 
105 105 105 105 105 114 2 2 2 2 2 67 57 57 66 115 105 105 105 114 2 2 2 59 16 16 16 16 70 64 1 2 111 113 105 105 105 114 1 2 113 105 105 112 110 2 1 11 10 1 111 108 105 105 105 105 105 105 104 104 
105 105 105 105 105 107 2 1 2 1 2 1 1 2 2 113 105 105 105 107 2 1 2 67 71 16 16 16 69 66 9 8 2 111 108 105 105 107 2 1 111 108 107 110 2 1 1 2 2 1 2 113 105 105 105 105 105 112 109 109 
105 105 105 105 105 107 2 2 1 2 1 2 1 2 1 111 113 105 105 105 114 2 2 2 67 57 71 69 66 2 11 10 1 2 113 105 105 105 114 106 115 105 107 1 1 2 2 2 1 2 2 111 108 105 105 105 107 110 1 1 
105 105 105 105 105 105 114 2 1 2 2 1 2 2 2 1 111 113 104 105 105 114 106 106 2 2 67 66 2 2 1 1 9 8 111 108 105 105 105 105 105 105 107 106 2 2 2 1 2 1 2 2 113 105 105 105 107 1 1 2 
105 105 105 105 105 105 107 106 106 106 1 2 2 1 2 2 2 111 109 113 104 105 105 105 114 2 2 1 1 1 9 6 14 5 2 113 105 105 105 105 105 105 105 105 114 2 2 2 2 2 2 1 111 108 105 105 107 2 2 2 
105 105 105 105 105 105 105 105 105 105 114 2 1 1 2 1 1 2 1 111 109 113 105 105 105 114 106 106 106 106 11 12 3 15 8 111 108 105 105 105 105 105 105 105 105 114 1 2 2 2 2 2 2 108 105 105 105 114 2 1 
105 105 105 105 105 105 105 105 105 105 107 106 2 1 2 2 2 2 2 2 1 111 113 105 105 105 105 105 105 105 114 11 12 13 10 1 108 105 105 105 105 105 105 105 105 105 114 2 1 2 1 1 2 108 105 105 105 107 2 2 
105 105 105 105 105 105 105 105 105 105 105 105 114 2 2 2 2 2 1 2 1 2 111 113 104 104 105 105 105 105 112 2 7 15 6 8 108 105 105 105 104 104 104 104 105 105 107 2 1 2 2 2 2 108 105 105 105 107 1 2 
105 105 105 105 105 105 105 105 105 105 105 105 112 2 2 2 2 1 1 2 1 1 1 111 109 109 113 104 104 112 110 1 11 12 13 10 113 104 104 112 109 109 109 109 113 105 105 114 2 1 2 1 2 108 105 105 105 107 2 1 
105 105 105 105 105 105 105 104 104 104 104 112 110 2 2 2 2 2 2 1 1 1 2 9 8 1 111 109 109 110 9 6 8 7 15 8 111 109 109 110 65 56 56 56 64 108 105 112 2 2 2 2 2 108 105 105 105 105 114 1 
105 105 105 105 105 105 112 109 109 109 109 110 2 2 2 2 1 2 2 2 2 2 1 11 10 9 8 9 6 6 14 3 15 14 3 15 8 1 2 65 68 16 16 16 58 113 112 110 1 2 2 2 2 108 105 105 105 105 107 2 
105 105 105 105 105 107 110 1 2 1 1 2 2 2 65 56 56 56 56 56 56 64 2 1 2 7 15 14 3 13 12 3 13 4 4 12 5 2 2 59 16 16 69 57 66 111 110 2 2 2 106 106 115 105 104 104 112 113 105 114 
105 105 105 105 105 107 106 2 1 2 1 2 2 65 68 16 16 16 69 71 16 70 64 2 1 7 3 13 4 10 11 4 10 1 2 11 10 2 65 68 16 69 66 2 2 2 2 1 2 2 108 105 105 112 109 109 110 111 108 105 
105 105 105 105 105 105 105 114 2 1 2 65 64 67 57 71 16 16 58 67 57 71 70 64 2 11 12 5 2 1 1 2 65 56 56 56 56 56 68 16 69 66 2 2 1 1 1 1 2 1 113 104 107 110 1 2 1 1 108 105 
105 105 105 105 105 105 105 105 114 106 106 59 70 64 2 59 16 16 58 1 65 68 16 58 9 8 11 10 1 65 56 56 68 16 16 16 16 16 16 69 66 2 1 2 2 2 2 2 2 2 111 109 108 114 115 114 2 2 108 105 
105 105 105 105 105 105 105 105 105 105 107 59 16 70 56 68 16 16 70 56 68 16 16 58 7 15 6 8 2 59 16 16 16 16 16 16 16 16 16 58 115 114 2 2 2 1 2 2 2 1 1 2 108 105 105 107 1 2 108 105 
105 105 105 105 105 105 105 105 105 105 107 59 16 16 16 16 16 16 16 16 16 16 69 66 11 12 13 10 1 59 16 16 16 16 16 16 16 16 69 66 108 105 114 2 1 2 2 2 2 2 1 1 113 105 105 105 114 106 108 105 
105 105 105 105 105 105 105 105 105 105 107 59 16 69 71 16 16 16 16 16 16 69 66 2 9 14 5 1 2 67 57 57 57 71 16 16 16 69 66 115 105 105 107 2 1 1 2 1 2 2 2 2 111 113 105 105 105 105 105 105 
105 105 105 105 105 105 104 104 104 104 112 67 71 70 68 16 69 57 71 69 57 66 1 2 7 13 10 2 115 114 106 106 106 67 71 16 16 58 115 105 105 105 105 114 106 106 2 1 2 1 2 2 2 111 108 105 105 105 105 105 
105 105 105 104 104 112 109 109 109 109 110 2 67 57 57 71 70 56 68 58 2 2 2 1 11 10 1 115 105 105 105 105 105 114 59 16 69 66 108 105 105 105 105 105 105 105 114 2 2 2 1 2 1 2 113 105 105 105 105 105 
104 104 112 109 109 110 2 2 2 1 1 2 2 1 2 67 57 57 57 66 2 1 9 8 1 2 106 108 105 105 105 105 105 107 67 57 66 2 113 104 105 105 104 104 105 105 105 114 2 2 2 2 2 2 111 108 105 105 105 105 
109 109 110 1 1 2 1 1 1 2 2 1 2 1 2 1 2 2 2 2 1 2 11 10 2 115 105 105 105 105 105 105 104 112 1 2 1 2 111 109 113 112 109 109 113 104 104 112 1 2 2 1 2 2 1 108 105 105 105 105 
1 2 2 2 2 2 1 2 2 2 2 2 2 1 1 1 2 1 2 1 1 1 2 1 2 113 104 105 105 105 105 107 109 110 2 2 2 2 2 1 111 110 1 2 111 109 109 110 2 2 2 1 1 2 2 108 105 105 105 105 
2 1 2 1 1 2 2 2 1 2 1 2 1 2 2 2 2 1 2 2 2 1 2 2 1 111 109 113 105 105 104 112 9 6 8 2 1 1 2 9 8 2 2 1 2 2 2 1 2 1 2 1 2 2 1 108 105 105 105 105 
2 2 2 2 2 2 1 2 106 106 106 106 2 1 1 2 1 2 2 2 2 2 2 65 56 56 56 64 113 112 109 110 7 13 10 9 8 2 1 11 10 2 1 2 2 2 2 1 1 2 2 2 2 2 2 108 105 105 105 105 
106 2 1 1 2 106 106 115 105 105 105 105 114 2 1 2 2 2 2 1 1 2 1 59 16 16 16 70 64 110 9 8 11 10 9 14 15 8 2 1 2 106 106 106 2 1 2 2 1 1 1 2 1 2 115 105 105 105 105 105 
105 114 115 114 115 105 105 105 105 105 104 104 112 2 106 106 115 114 2 2 1 2 65 68 69 71 16 69 66 1 11 10 2 9 14 13 12 15 8 2 115 105 105 105 114 106 106 106 2 2 2 2 1 2 108 105 105 105 105 105 
105 105 105 105 105 105 105 105 105 112 109 109 106 115 105 105 105 112 2 2 65 56 68 16 70 68 16 58 1 2 2 9 6 14 3 15 14 13 10 2 108 105 105 104 104 105 105 105 114 106 2 2 1 2 108 105 105 105 105 105 
105 105 105 105 105 105 105 105 107 110 2 2 113 105 105 105 112 110 2 65 68 16 16 16 16 16 16 58 2 1 2 11 4 12 3 3 13 10 2 2 113 104 112 109 109 113 105 105 105 107 2 1 1 2 108 105 105 105 105 105 
105 105 105 105 105 105 105 105 105 114 106 106 115 105 105 107 110 65 56 68 69 71 16 69 71 16 16 70 64 2 2 1 9 14 3 13 10 2 2 1 111 109 110 1 1 111 113 105 105 112 2 2 2 115 105 105 105 105 105 105 
105 105 105 105 104 112 113 105 105 105 105 105 105 105 105 107 2 59 16 16 70 68 16 58 67 71 16 16 70 56 64 2 11 12 3 5 1 2 65 56 56 64 2 2 1 1 111 108 105 114 1 2 2 108 105 105 105 105 105 105 
105 105 105 112 109 110 111 108 105 105 105 105 105 105 105 105 114 67 57 71 16 16 16 58 2 67 57 71 16 16 70 56 53 127 45 126 54 56 68 16 16 70 56 64 2 1 2 108 105 107 1 2 2 113 105 105 105 105 105 105 
105 105 105 114 106 106 115 105 105 105 105 105 105 105 105 105 105 114 106 67 57 71 16 70 56 64 1 59 16 16 16 16 23 39 39 39 22 16 16 69 57 71 16 70 64 2 2 113 105 105 114 2 2 111 108 105 105 105 105 105 
105 105 105 105 105 105 105 105 105 104 104 104 104 104 105 105 105 105 105 114 106 67 71 16 16 70 56 68 16 16 16 16 23 39 39 39 22 16 16 58 1 67 71 16 70 56 64 111 108 105 112 2 2 1 108 105 105 105 105 105 
105 105 105 105 105 105 105 105 112 109 109 109 109 109 113 105 105 105 105 105 105 114 67 57 71 16 16 16 69 57 57 57 52 125 47 124 55 57 71 70 64 65 68 69 57 57 66 1 113 112 110 2 1 1 108 105 105 105 104 104 
105 105 105 105 105 105 105 107 110 2 2 1 1 2 111 113 104 104 105 105 105 105 114 106 59 16 16 69 66 2 2 9 6 14 3 5 2 2 67 71 70 68 69 66 1 2 1 1 111 110 1 1 2 106 108 105 105 107 109 109 
105 105 105 105 105 105 105 107 106 1 2 1 2 2 1 111 109 109 113 104 104 104 104 112 67 57 57 66 2 2 1 7 3 3 3 15 8 1 2 59 16 69 66 1 1 1 2 1 2 1 1 2 115 105 105 105 105 112 2 1 
105 105 105 105 105 105 105 105 105 114 2 1 2 1 1 1 2 2 111 109 109 109 109 110 2 2 2 1 2 2 9 14 3 13 4 12 5 2 65 68 16 70 64 2 2 2 1 2 2 1 2 115 105 105 105 105 107 110 1 1 
105 105 105 105 105 105 105 105 105 105 114 106 106 2 2 2 2 1 1 2 2 1 1 2 1 1 2 2 2 1 11 4 12 5 2 11 10 2 67 57 71 16 58 2 1 2 106 106 106 106 115 105 105 105 105 105 112 2 2 2 
105 105 105 105 105 105 105 105 105 105 105 105 105 114 1 1 2 106 106 106 2 1 2 2 2 1 2 1 2 2 2 2 11 10 9 8 2 106 115 114 67 57 66 1 2 115 105 105 105 105 105 105 105 105 105 112 110 1 1 1 
105 105 105 105 105 105 105 105 105 105 105 105 105 105 114 106 115 105 105 105 114 106 106 106 2 2 2 2 2 2 2 1 1 1 11 10 115 105 105 105 114 106 106 106 115 105 105 105 105 105 105 105 105 104 112 110 1 2 106 106 
105 105 105 105 105 105 105 105 105 105 105 105 105 105 105 105 105 105 105 105 105 105 105 105 114 2 2 2 1 1 2 2 2 2 2 106 108 105 105 105 105 105 105 105 105 105 105 105 105 105 104 104 112 109 110 2 106 115 105 105 
105 105 105 105 105 105 105 105 105 105 105 105 105 105 105 105 105 105 105 105 105 105 105 105 107 2 1 2 1 2 2 2 106 106 115 105 105 105 105 105 105 105 105 105 105 105 105 105 104 112 109 109 110 1 2 115 105 105 105 105 
105 105 105 105 105 105 105 105 105 105 105 105 105 105 105 105 105 105 105 105 105 105 105 105 105 114 2 2 2 2 2 115 105 105 105 105 105 105 105 105 105 105 105 105 105 105 105 107 109 110 1 1 1 2 106 108 105 105 105 105 
105 105 105 105 105 105 105 105 105 105 105 105 105 105 105 105 105 105 105 105 105 105 105 105 105 107 2 2 2 2 2 108 105 105 105 105 105 105 105 105 105 105 105 105 105 105 105 107 2 1 1 2 2 115 105 105 105 105 105 105 

[COLLISION]
0 0 0 0 0 0 0 0 0 0 0 0 0 0 0 0 0 0 0 0 0 0 0 0 0 0 0 0 0 0 0 0 0 0 0 0 0 0 0 0 0 0 0 0 0 0 0 0 0 0 0 0 0 0 0 0 0 0 0 0 
0 0 0 0 0 0 0 0 0 0 0 0 0 0 0 0 0 0 0 0 0 0 0 0 0 0 0 0 0 0 0 0 0 0 0 0 0 0 0 0 0 0 0 0 1 1 1 6 7 0 0 0 0 0 0 0 0 0 0 0 
0 0 0 0 0 0 0 0 0 0 0 0 0 0 0 0 0 0 0 0 0 0 0 0 0 0 0 0 0 0 0 0 0 0 0 0 0 0 0 0 0 1 1 6 0 0 0 0 12 2 7 0 0 0 0 0 0 0 0 0 
0 0 0 0 0 0 0 0 0 0 0 0 0 0 0 0 0 0 0 0 0 0 0 0 0 0 0 0 0 0 0 0 0 0 0 0 0 1 1 1 6 0 0 0 0 0 0 0 0 0 12 7 0 0 0 0 0 0 0 0 
0 0 0 0 0 0 0 0 0 0 0 0 0 0 0 0 0 0 0 0 0 0 0 0 0 0 0 0 0 0 0 0 0 0 1 1 6 0 0 0 0 0 0 0 0 0 0 0 0 0 0 12 7 0 0 0 0 0 0 0 
0 0 0 0 0 0 0 0 0 0 0 0 0 0 0 0 0 0 0 0 0 0 0 0 0 0 0 0 0 0 0 1 1 6 0 0 0 0 0 0 0 0 0 0 0 0 0 0 0 0 0 0 12 7 0 0 0 0 0 0 
0 0 0 0 0 0 0 0 0 0 0 0 0 0 0 0 0 0 0 0 0 0 0 0 0 0 0 0 0 0 6 0 0 0 0 0 0 0 0 0 0 0 0 0 0 0 0 0 0 0 0 0 0 3 0 0 0 0 0 0 
0 0 0 0 0 0 0 0 0 6 2 7 0 0 0 6 2 2 7 0 0 0 0 0 0 0 0 0 0 6 0 0 0 0 0 0 0 0 0 4 0 0 0 0 0 0 0 0 0 0 0 0 0 12 7 0 0 0 0 0 
0 0 0 0 0 0 0 1 6 0 0 12 2 2 2 13 0 0 0 7 0 0 1 1 0 0 0 0 6 0 0 0 0 0 0 0 4 4 9 0 8 0 0 0 0 0 0 0 0 0 0 0 0 4 9 0 0 0 0 0 
0 0 0 0 0 0 1 0 0 0 0 0 0 0 0 0 0 0 0 0 7 6 0 0 7 1 0 1 0 0 0 0 0 0 0 9 0 0 0 0 0 8 0 0 0 0 0 0 0 0 0 0 9 0 0 0 0 0 0 0 
0 0 0 0 0 0 6 0 0 0 0 0 0 0 0 0 0 0 0 0 0 0 0 0 0 0 7 6 0 0 0 0 0 4 9 0 0 0 0 0 0 1 4 0 0 0 0 0 0 0 0 0 1 0 0 0 0 0 0 0 
0 0 0 0 0 1 0 0 0 0 0 10 4 4 4 11 0 0 0 0 0 0 0 0 0 0 0 0 0 0 0 0 9 0 0 0 0 0 0 0 0 0 0 8 0 0 0 0 0 0 0 9 0 0 0 0 0 0 0 0 
0 0 0 0 0 6 0 0 0 0 0 3 0 0 0 8 11 0 0 0 0 0 0 10 11 0 0 0 0 0 0 0 1 0 0 0 0 0 0 0 0 0 0 0 8 0 0 0 0 0 9 0 0 0 0 0 0 0 0 0 
0 0 0 0 1 0 0 0 0 0 10 9 0 0 0 0 8 9 8 0 0 0 10 9 8 4 11 0 0 0 0 0 1 0 0 0 0 0 0 0 0 0 0 0 1 0 0 0 0 0 1 0 0 0 0 0 0 0 0 0 
0 0 0 0 1 0 0 0 0 0 12 7 0 0 0 0 0 0 1 0 0 0 12 7 0 0 8 4 11 0 0 0 7 0 0 0 0 0 0 0 0 0 0 0 6 0 0 0 0 0 7 0 0 0 0 0 0 0 0 0 
0 0 0 0 0 8 0 0 0 0 0 12 2 2 2 1 0 0 0 8 0 0 0 3 0 0 0 0 8 11 0 0 0 7 0 0 0 0 0 0 0 0 0 6 0 0 0 0 0 0 0 1 0 0 0 0 0 0 0 0 
0 0 0 0 0 1 0 0 0 0 0 0 0 0 0 7 0 0 0 1 0 0 0 12 7 0 0 0 6 13 0 0 0 0 1 0 0 0 0 0 0 0 1 0 0 0 0 0 0 0 0 7 0 0 0 0 0 0 0 0 
0 0 0 0 0 1 0 0 0 0 0 0 0 0 0 0 7 0 0 0 8 0 0 0 12 2 7 6 13 0 0 0 0 0 7 0 0 0 0 0 0 0 1 0 0 0 0 0 0 0 0 0 1 0 0 0 0 0 0 0 
0 0 0 0 0 0 8 0 0 0 0 0 0 0 0 0 0 7 1 0 0 8 4 4 0 0 12 13 0 0 0 0 0 0 0 1 0 0 0 0 0 0 1 4 0 0 0 0 0 0 0 0 7 0 0 0 0 0 0 0 
0 0 0 0 0 0 1 4 4 4 0 0 0 0 0 0 0 0 0 7 1 0 0 0 8 0 0 0 0 0 0 0 0 0 0 7 0 0 0 0 0 0 0 0 8 0 0 0 0 0 0 0 0 1 0 0 0 0 0 0 
0 0 0 0 0 0 0 0 0 0 8 0 0 0 0 0 0 0 0 0 0 7 0 0 0 8 4 4 4 4 0 0 0 0 0 0 1 0 0 0 0 0 0 0 0 8 0 0 0 0 0 0 0 1 0 0 0 0 0 0 
0 0 0 0 0 0 0 0 0 0 1 4 0 0 0 0 0 0 0 0 0 0 7 0 0 0 0 0 0 0 8 0 0 0 0 0 1 0 0 0 0 0 0 0 0 0 8 0 0 0 0 0 0 1 0 0 0 0 0 0 
0 0 0 0 0 0 0 0 0 0 0 0 8 0 0 0 0 0 0 0 0 0 0 7 1 1 0 0 0 0 6 0 0 0 0 0 1 0 0 0 1 1 1 1 0 0 1 0 0 0 0 0 0 1 0 0 0 0 0 0 
0 0 0 0 0 0 0 0 0 0 0 0 6 0 0 0 0 0 0 0 0 0 0 0 0 0 7 1 1 6 0 0 0 0 0 0 7 1 1 6 0 0 0 0 7 0 0 8 0 0 0 0 0 1 0 0 0 0 0 0 
0 0 0 0 0 0 0 1 1 1 1 6 0 0 0 0 0 0 0 0 0 0 0 0 0 0 0 0 0 0 0 0 0 0 0 0 0 0 0 0 10 4 4 4 11 1 0 6 0 0 0 0 0 1 0 0 0 0 0 0 
0 0 0 0 0 0 6 0 0 0 0 0 0 0 0 0 0 0 0 0 0 0 0 0 0 0 0 0 0 0 0 0 0 0 0 0 0 0 0 10 9 0 0 0 5 7 6 0 0 0 0 0 0 1 0 0 0 0 0 0 
0 0 0 0 0 1 0 0 0 0 0 0 0 0 10 4 4 4 4 4 4 11 0 0 0 0 0 0 0 0 0 0 0 0 0 0 0 0 0 3 0 0 6 2 13 0 0 0 0 0 4 4 9 0 0 0 0 0 0 0 
0 0 0 0 0 1 4 0 0 0 0 0 0 10 9 0 0 0 0 0 0 8 11 0 0 0 0 0 0 0 0 0 0 0 0 0 0 0 10 9 0 6 13 0 0 0 0 0 0 0 1 0 0 0 0 0 0 0 0 0 
0 0 0 0 0 0 0 8 0 0 0 10 11 12 2 7 0 0 0 0 0 0 8 11 0 0 0 0 0 0 0 0 10 4 4 4 4 4 9 0 6 13 0 0 0 0 0 0 0 0 7 1 0 0 0 0 0 0 0 0 
0 0 0 0 0 0 0 0 8 4 4 9 8 11 0 3 0 0 0 0 0 0 0 5 0 0 0 0 0 10 4 4 9 0 0 0 0 0 0 0 5 0 0 0 0 0 0 0 0 0 0 0 1 0 0 0 0 0 0 0 
0 0 0 0 0 0 0 0 0 0 0 0 0 8 4 9 0 0 0 0 0 0 0 5 0 0 0 0 0 3 0 0 0 0 0 0 0 0 0 0 1 8 0 0 0 0 0 0 0 0 0 0 1 0 0 0 0 0 0 0 
0 0 0 0 0 0 0 0 0 0 0 0 0 0 0 0 0 0 0 0 0 0 6 13 0 0 0 0 0 3 0 0 0 0 0 0 0 0 0 0 0 0 8 0 0 0 0 0 0 0 0 0 7 0 0 0 0 0 0 0 
0 0 0 0 0 0 0 0 0 0 0 0 0 0 0 0 0 0 0 0 0 6 13 0 0 0 0 0 0 3 0 0 0 0 0 0 0 0 0 0 0 0 1 0 0 0 0 0 0 0 0 0 0 7 0 0 0 0 0 0 
0 0 0 0 0 0 1 1 1 1 6 2 7 0 0 0 0 0 0 6 2 13 0 0 0 0 0 0 9 1 0 0 0 0 0 0 0 0 0 0 0 0 0 8 4 4 0 0 0 0 0 0 0 0 1 0 0 0 0 0 
0 0 0 1 1 6 0 0 0 0 0 0 12 2 2 7 0 0 0 5 0 0 0 0 0 0 0 9 0 0 0 0 0 0 0 0 6 2 1 0 0 0 0 0 0 0 8 0 0 0 0 0 0 0 7 0 0 0 0 0 
1 1 6 0 0 0 0 0 0 0 0 0 0 0 0 12 2 2 2 13 0 0 0 0 0 0 4 1 0 0 0 0 0 1 2 2 13 0 7 1 0 0 1 1 0 0 0 8 0 0 0 0 0 0 0 1 0 0 0 0 
0 0 0 0 0 0 0 0 0 0 0 0 0 0 0 0 0 0 0 0 0 0 0 0 0 9 0 0 0 0 0 0 1 6 0 0 0 0 0 0 7 6 0 0 7 1 1 6 0 0 0 0 0 0 0 1 0 0 0 0 
0 0 0 0 0 0 0 0 0 0 0 0 0 0 0 0 0 0 0 0 0 0 0 0 0 7 1 0 0 0 0 1 0 0 0 0 0 0 0 0 0 0 0 0 0 0 0 0 0 0 0 0 0 0 0 1 0 0 0 0 
0 0 0 0 0 0 0 0 0 0 0 0 0 0 0 0 0 0 0 0 0 0 0 0 0 0 0 7 0 0 1 6 0 0 0 0 0 0 0 0 0 0 0 0 0 0 0 0 0 0 0 0 0 0 0 1 0 0 0 0 
0 0 0 0 0 0 0 0 4 4 4 4 0 0 0 0 0 0 0 0 0 0 0 10 4 4 4 9 1 6 0 0 0 0 0 0 0 0 0 0 0 0 0 0 0 0 0 0 0 0 0 0 0 0 0 1 0 0 0 0 
4 0 0 0 0 4 4 9 0 0 0 0 8 0 0 0 0 0 0 0 0 0 0 3 0 0 0 0 5 0 0 0 0 0 0 0 0 0 0 0 0 4 4 4 0 0 0 0 0 0 0 0 0 0 9 0 0 0 0 0 
0 8 9 8 9 0 0 0 0 0 0 0 1 0 4 4 9 8 0 0 0 0 10 9 0 0 0 6 13 0 0 0 0 0 0 0 0 0 0 0 9 0 0 0 8 4 4 4 0 0 0 0 0 0 1 0 0 0 0 0 
0 0 0 0 0 0 0 0 0 0 0 0 0 1 0 0 0 6 0 0 10 4 9 0 0 0 0 5 0 0 0 0 0 0 0 0 0 0 0 0 1 0 0 1 1 0 0 0 8 4 0 0 0 0 1 0 0 0 0 0 
0 0 0 0 0 0 0 0 0 0 0 0 0 0 0 0 6 0 0 10 9 0 0 0 0 0 0 5 0 0 0 0 0 0 0 0 0 0 0 0 7 1 6 0 0 7 0 0 0 1 0 0 0 0 1 0 0 0 0 0 
0 0 0 0 0 0 0 0 0 0 0 0 0 0 0 1 0 10 4 9 0 0 0 0 0 0 0 8 11 0 0 0 0 0 0 0 0 0 0 0 0 0 0 0 0 0 7 0 0 6 0 0 0 9 0 0 0 0 0 0 
0 0 0 0 0 0 0 0 0 0 0 0 0 0 0 1 0 3 0 0 0 0 0 0 0 0 0 0 8 4 11 0 0 0 0 0 0 0 10 4 4 11 0 0 0 0 0 1 0 8 0 0 0 1 0 0 0 0 0 0 
0 0 0 0 0 0 0 0 0 0 0 0 0 0 0 0 8 9 0 0 0 0 0 0 0 0 0 0 0 0 8 4 11 0 0 0 10 4 9 0 0 8 4 11 0 0 0 1 0 1 0 0 0 7 0 0 0 0 0 0 
0 0 0 0 0 0 0 0 0 0 0 0 0 0 0 0 0 0 0 0 0 0 0 0 0 0 0 0 0 0 0 0 5 0 0 0 3 0 0 0 0 0 0 8 11 0 0 7 0 0 8 0 0 0 1 0 0 0 0 0 
0 0 0 0 0 0 0 0 0 1 1 1 1 1 0 0 0 0 0 0 0 0 0 0 0 0 0 0 0 0 0 0 5 0 0 0 3 0 0 0 0 0 0 0 8 4 11 0 1 0 6 0 0 0 1 0 0 0 0 0 
0 0 0 0 0 0 0 0 6 0 0 0 0 0 7 0 0 0 0 0 0 0 0 0 0 0 0 0 6 2 2 2 13 0 0 0 12 2 7 0 0 0 0 6 2 2 13 0 7 6 0 0 0 0 1 0 0 0 0 0 
0 0 0 0 0 0 0 1 0 0 0 0 0 0 0 7 1 1 0 0 0 0 0 0 0 0 0 6 13 0 0 0 0 0 0 0 0 0 12 7 0 0 6 13 0 0 0 0 0 0 0 0 0 4 1 0 0 0 0 0 
0 0 0 0 0 0 0 1 4 0 0 0 0 0 0 0 0 0 7 1 1 1 1 6 2 2 2 13 0 0 0 0 0 0 0 0 0 0 0 3 0 6 13 0 0 0 0 0 0 0 0 0 9 0 0 0 0 0 0 0 
0 0 0 0 0 0 0 0 0 8 0 0 0 0 0 0 0 0 0 0 0 0 0 0 0 0 0 0 0 0 0 0 0 0 0 0 0 0 10 9 0 8 11 0 0 0 0 0 0 0 0 9 0 0 0 0 0 0 0 0 
0 0 0 0 0 0 0 0 0 0 8 4 4 0 0 0 0 0 0 0 0 0 0 0 0 0 0 0 0 0 0 0 0 0 0 0 0 0 3 0 0 0 5 0 0 0 4 4 4 4 9 0 0 0 0 0 0 0 0 0 
0 0 0 0 0 0 0 0 0 0 0 0 0 8 0 0 0 4 4 4 0 0 0 0 0 0 0 0 0 0 0 0 0 0 0 0 0 4 9 0 6 2 13 0 0 9 0 0 0 0 0 0 0 0 0 0 0 0 0 0 
0 0 0 0 0 0 0 0 0 0 0 0 0 0 8 4 9 0 0 0 8 4 4 4 0 0 0 0 0 0 0 0 0 0 0 0 9 0 0 0 8 4 4 4 9 0 0 0 0 0 0 0 0 0 0 0 0 0 0 0 
0 0 0 0 0 0 0 0 0 0 0 0 0 0 0 0 0 0 0 0 0 0 0 0 8 0 0 0 0 0 0 0 0 0 0 4 1 0 0 0 0 0 0 0 0 0 0 0 0 0 0 0 0 0 0 0 0 0 0 0 
0 0 0 0 0 0 0 0 0 0 0 0 0 0 0 0 0 0 0 0 0 0 0 0 1 0 0 0 0 0 0 0 4 4 9 0 0 0 0 0 0 0 0 0 0 0 0 0 0 0 0 0 0 0 0 0 0 0 0 0 
0 0 0 0 0 0 0 0 0 0 0 0 0 0 0 0 0 0 0 0 0 0 0 0 3 8 0 0 0 0 0 9 0 0 0 0 0 0 0 0 0 0 0 0 0 0 0 0 0 0 0 0 0 0 0 0 0 0 0 0 
0 0 0 0 0 0 0 0 0 0 0 0 0 0 0 0 0 0 0 0 0 0 0 0 0 1 0 0 0 0 0 1 0 0 0 0 0 0 0 0 0 0 0 0 0 0 0 0 0 0 0 0 0 0 0 0 0 0 0 0 
