[TILESET]
TileSheet

[TERRAIN]
105 105 105 105 105 105 105 105 105 105 105 105 105 105 105 105 105 105 105 105 105 105 105 105 105 105 105 105 105 105 105 105 105 105 105 105 105 105 105 105 
105 105 105 105 105 105 105 105 105 105 105 105 105 105 105 105 105 105 104 104 104 104 104 104 104 104 104 105 105 105 105 105 105 105 105 105 105 105 105 105 
105 105 105 105 105 105 105 105 105 105 105 105 105 105 105 105 104 112 109 109 109 109 109 109 109 109 109 113 104 104 105 105 105 105 105 105 105 105 105 105 
105 105 105 105 105 105 105 105 105 105 105 105 104 104 104 112 109 110 2 1 2 1 2 2 2 1 2 111 109 109 113 104 104 105 105 105 105 105 105 105 
105 105 105 105 105 105 105 105 105 105 104 112 109 109 109 110 1 2 2 2 2 2 2 65 64 2 1 1 1 2 111 109 109 108 105 105 105 105 105 105 
105 105 105 105 105 105 105 105 104 112 109 110 2 2 2 2 1 1 1 2 2 2 65 68 70 64 2 2 2 2 2 1 2 113 105 105 105 105 105 105 
105 105 105 105 105 105 105 112 109 110 2 2 2 1 1 1 2 2 2 2 2 65 68 16 16 58 2 1 1 2 2 1 2 111 113 105 105 105 105 105 
105 105 105 105 105 105 107 110 2 1 2 1 1 2 2 2 2 2 2 2 65 68 16 16 16 58 1 2 2 2 2 2 2 2 111 108 105 105 105 105 
105 105 105 105 105 105 112 2 2 1 2 2 1 2 2 2 1 2 2 2 67 57 71 16 16 58 2 1 2 1 65 64 2 1 1 113 105 105 105 105 
105 105 105 105 105 107 110 2 1 2 2 2 2 65 56 64 1 1 2 2 1 2 67 57 71 58 2 2 2 65 68 70 64 2 2 111 108 105 105 105 
105 105 105 105 105 107 2 2 1 2 2 65 56 68 16 58 2 2 2 2 2 1 2 2 67 66 2 1 65 68 16 16 70 64 2 2 108 105 105 105 
105 105 105 105 105 112 2 2 2 2 1 59 16 16 16 58 2 2 1 1 2 1 1 2 2 2 2 65 68 16 16 16 16 58 2 1 108 105 105 105 
105 105 105 105 112 110 2 2 2 2 1 59 16 16 16 58 2 1 2 2 2 2 1 2 65 64 2 67 57 57 71 16 69 66 2 1 108 105 105 105 
105 105 104 112 110 2 2 1 2 2 2 59 16 16 69 66 2 1 1 1 2 2 65 56 68 58 2 2 2 1 67 57 66 1 1 2 108 105 105 105 
104 112 109 110 2 2 1 2 1 2 65 68 16 16 58 2 2 2 1 2 65 56 68 16 16 58 2 1 1 2 2 1 2 2 2 115 105 105 105 105 
109 110 2 2 2 2 1 1 2 1 59 16 16 16 58 1 1 2 1 1 67 71 16 16 16 58 1 2 2 2 1 1 2 2 2 108 105 105 105 105 
1 1 1 2 1 2 2 1 2 2 67 71 16 16 70 64 2 2 2 1 2 67 71 16 69 66 2 1 2 2 2 1 2 2 115 105 105 105 105 105 
2 1 1 2 2 1 2 2 2 1 2 59 16 16 16 58 2 1 2 2 2 2 67 71 58 2 2 1 2 2 1 1 2 2 108 105 105 105 105 105 
2 2 2 2 2 2 2 1 1 1 2 59 16 16 16 70 56 64 2 2 1 2 1 67 66 2 1 2 2 2 2 2 2 115 105 105 105 105 105 105 
106 106 115 114 106 2 2 2 1 2 2 67 57 71 16 16 16 70 64 2 2 2 1 2 2 1 2 2 1 2 2 106 115 105 105 105 105 105 105 105 
105 105 105 105 105 114 106 2 2 2 1 2 2 67 57 71 16 69 66 2 2 2 2 2 2 2 1 2 106 106 115 105 105 105 105 105 105 105 105 105 
105 105 105 105 105 105 105 114 2 1 2 2 2 2 2 59 69 66 1 2 1 1 2 1 2 2 2 115 105 105 105 105 105 105 105 105 105 105 105 105 
105 105 105 105 105 105 105 105 114 1 2 2 1 1 2 67 66 2 2 2 1 2 2 1 1 2 115 105 105 105 105 105 105 105 105 105 105 105 105 105 
105 105 105 105 105 105 105 105 105 114 2 1 1 2 1 2 2 1 1 2 1 1 2 2 1 2 113 104 105 105 105 105 105 105 105 105 105 105 105 105 
105 105 105 105 105 105 105 105 105 107 2 1 2 2 2 2 2 2 2 2 2 1 2 2 2 2 111 109 113 104 104 105 105 105 105 105 105 105 105 105 
105 105 105 105 105 105 105 105 105 107 2 1 1 2 2 2 1 2 2 2 1 2 2 1 2 1 1 1 111 109 109 113 104 105 105 105 105 105 105 105 
105 105 105 105 105 105 105 105 105 107 2 2 1 1 2 2 2 2 1 2 2 2 2 1 2 1 2 2 2 2 1 111 109 108 105 105 105 105 105 105 
105 105 105 105 105 105 105 105 105 112 2 2 2 1 1 2 2 2 2 2 2 106 106 2 2 1 2 2 2 1 2 1 2 113 105 105 105 105 105 105 
105 105 105 105 105 105 105 105 112 110 2 2 2 2 2 2 2 2 106 106 115 105 105 114 106 2 2 1 2 2 2 1 2 111 108 105 105 105 105 105 
105 105 105 105 105 105 105 112 110 2 2 2 2 1 1 2 106 115 105 105 105 105 105 105 105 114 106 2 2 1 1 1 2 2 108 105 105 105 105 105 
105 105 105 105 105 105 107 1 2 2 2 2 1 2 2 115 105 105 105 105 105 105 105 105 105 105 105 114 2 1 2 2 106 106 108 105 105 105 105 105 
105 105 105 105 105 105 107 2 1 2 1 2 2 2 115 105 105 105 105 105 105 105 105 105 105 105 105 105 114 106 106 115 105 105 105 105 105 105 105 105 
105 105 105 105 105 105 105 114 106 2 2 1 2 115 105 105 105 105 105 105 105 105 105 105 105 105 105 105 105 105 105 105 105 105 105 105 105 105 105 105 
105 105 105 105 105 105 105 105 105 114 106 106 106 108 105 105 105 105 105 105 105 105 105 105 105 105 105 105 105 105 105 105 105 105 105 105 105 105 105 105 
105 105 105 105 105 105 105 105 105 105 105 105 105 105 105 105 105 105 105 105 105 105 105 105 105 105 105 105 105 105 105 105 105 105 105 105 105 105 105 105 
105 105 105 105 105 105 105 105 105 105 105 105 105 105 105 105 105 105 105 105 105 105 105 105 105 105 105 105 105 105 105 105 105 105 105 105 105 105 105 105 
105 105 105 105 105 105 105 105 105 105 105 105 105 105 105 105 105 105 105 105 105 105 105 105 105 105 105 105 105 105 105 105 105 105 105 105 105 105 105 105 
105 105 105 105 105 105 105 105 105 105 105 105 105 105 105 105 105 105 105 105 105 105 105 105 105 105 105 105 105 105 105 105 105 105 105 105 105 105 105 105 
105 105 105 105 105 105 105 105 105 105 105 105 105 105 105 105 105 105 105 105 105 105 105 105 105 105 105 105 105 105 105 105 105 105 105 105 105 105 105 105 
105 105 105 105 105 105 105 105 105 105 105 105 105 105 105 105 105 105 105 105 105 105 105 105 105 105 105 105 105 105 105 105 105 105 105 105 105 105 105 105 

[COLLISION]
0 0 0 0 0 0 0 0 0 0 0 0 0 0 0 0 0 0 0 0 0 0 0 0 0 0 0 0 0 0 0 0 0 0 0 0 0 0 0 0 
0 0 0 0 0 0 0 0 0 0 0 0 0 0 0 0 0 0 1 1 1 1 1 1 1 1 1 0 0 0 0 0 0 0 0 0 0 0 0 0 
0 0 0 0 0 0 0 0 0 0 0 0 0 0 0 0 1 6 0 0 0 0 0 0 0 0 0 7 1 1 0 0 0 0 0 0 0 0 0 0 
0 0 0 0 0 0 0 0 0 0 0 0 1 1 1 6 0 0 0 0 0 0 0 0 0 0 0 0 0 0 7 1 1 0 0 0 0 0 0 0 
0 0 0 0 0 0 0 0 0 0 1 6 0 0 0 0 0 0 0 0 0 0 0 10 11 0 0 0 0 0 0 0 0 1 0 0 0 0 0 0 
0 0 0 0 0 0 0 0 1 6 0 0 0 0 0 0 0 0 0 0 0 0 10 9 8 11 0 0 0 0 0 0 0 7 0 0 0 0 0 0 
0 0 0 0 0 0 0 6 0 0 0 0 0 0 0 0 0 0 0 0 0 10 9 0 0 5 0 0 0 0 0 0 0 0 7 0 0 0 0 0 
0 0 0 0 0 0 1 0 0 0 0 0 0 0 0 0 0 0 0 0 10 9 0 0 0 5 0 0 0 0 0 0 0 0 0 1 0 0 0 0 
0 0 0 0 0 0 6 0 0 0 0 0 0 0 0 0 0 0 0 0 12 2 7 0 0 5 0 0 0 0 10 11 0 0 0 7 0 0 0 0 
0 0 0 0 0 1 0 0 0 0 0 0 0 10 4 11 0 0 0 0 0 0 12 2 7 5 0 0 0 10 9 8 11 0 0 0 1 0 0 0 
0 0 0 0 0 1 0 0 0 0 0 10 4 9 0 5 0 0 0 0 0 0 0 0 12 13 0 0 10 9 0 0 8 11 0 0 1 0 0 0 
0 0 0 0 0 6 0 0 0 0 0 3 0 0 0 5 0 0 0 0 0 0 0 0 0 0 0 10 9 0 0 0 0 5 0 0 1 0 0 0 
0 0 0 0 6 0 0 0 0 0 0 3 0 0 0 5 0 0 0 0 0 0 0 0 10 11 0 12 2 2 7 0 6 13 0 0 1 0 0 0 
0 0 1 6 0 0 0 0 0 0 0 3 0 0 6 13 0 0 0 0 0 0 10 4 9 5 0 0 0 0 12 2 13 0 0 0 1 0 0 0 
1 6 0 0 0 0 0 0 0 0 10 9 0 0 5 0 0 0 0 0 10 4 9 0 0 5 0 0 0 0 0 0 0 0 0 9 0 0 0 0 
0 0 0 0 0 0 0 0 0 0 3 0 0 0 5 0 0 0 0 0 12 7 0 0 0 5 0 0 0 0 0 0 0 0 0 1 0 0 0 0 
0 0 0 0 0 0 0 0 0 0 12 7 0 0 8 11 0 0 0 0 0 12 7 0 6 13 0 0 0 0 0 0 0 0 9 0 0 0 0 0 
0 0 0 0 0 0 0 0 0 0 0 3 0 0 0 5 0 0 0 0 0 0 12 7 5 0 0 0 0 0 0 0 0 0 1 0 0 0 0 0 
0 0 0 0 0 0 0 0 0 0 0 3 0 0 0 8 4 11 0 0 0 0 0 12 13 0 0 0 0 0 0 0 0 9 0 0 0 0 0 0 
4 4 9 8 4 0 0 0 0 0 0 12 2 7 0 0 0 8 11 0 0 0 0 0 0 0 0 0 0 0 0 0 9 0 0 0 0 0 0 0 
0 0 0 0 0 8 4 0 0 0 0 0 0 12 2 7 0 6 13 0 0 0 0 0 0 0 0 0 0 0 9 0 0 0 0 0 0 0 0 0 
0 0 0 0 0 0 0 8 0 0 0 0 0 0 0 3 6 13 0 0 0 0 0 0 0 0 0 9 0 0 0 0 0 0 0 0 0 0 0 0 
0 0 0 0 0 0 0 0 8 0 0 0 0 0 0 12 13 0 0 0 0 0 0 0 0 0 9 0 0 0 0 0 0 0 0 0 0 0 0 0 
0 0 0 0 0 0 0 0 0 8 0 0 0 0 0 0 0 0 0 0 0 0 0 0 0 0 7 1 0 0 0 0 0 0 0 0 0 0 0 0 
0 0 0 0 0 0 0 0 0 1 0 0 0 0 0 0 0 0 0 0 0 0 0 0 0 0 0 0 7 1 1 0 0 0 0 0 0 0 0 0 
0 0 0 0 0 0 0 0 0 1 0 0 0 0 0 0 0 0 0 0 0 0 0 0 0 0 0 0 0 0 0 7 1 0 0 0 0 0 0 0 
0 0 0 0 0 0 0 0 0 1 0 0 0 0 0 0 0 0 0 0 0 0 0 0 0 0 0 0 0 0 0 0 0 1 0 0 0 0 0 0 
0 0 0 0 0 0 0 0 0 6 0 0 0 0 0 0 0 0 0 0 0 4 4 0 0 0 0 0 0 0 0 0 0 7 0 0 0 0 0 0 
0 0 0 0 0 0 0 0 6 0 0 0 0 0 0 0 0 0 4 4 9 0 0 8 4 0 0 0 0 0 0 0 0 0 1 0 0 0 0 0 
0 0 0 0 0 0 0 6 0 0 0 0 0 0 0 0 4 9 0 0 0 0 0 0 0 8 4 0 0 0 0 0 0 0 1 0 0 0 0 0 
0 0 0 0 0 0 1 0 0 0 0 0 0 0 0 9 0 0 0 0 0 0 0 0 0 0 0 8 0 0 0 0 4 4 1 0 0 0 0 0 
0 0 0 0 0 0 1 0 0 0 0 0 0 0 9 0 0 0 0 0 0 0 0 0 0 0 0 0 8 4 4 9 0 0 0 0 0 0 0 0 
0 0 0 0 0 0 0 8 4 0 0 0 0 9 0 0 0 0 0 0 0 0 0 0 0 0 0 0 0 0 0 0 0 0 0 0 0 0 0 0 
0 0 0 0 0 0 0 0 0 8 4 4 4 1 0 0 0 0 0 0 0 0 0 0 0 0 0 0 0 0 0 0 0 0 0 0 0 0 0 0 
0 0 0 0 0 0 0 0 0 0 0 0 0 0 0 0 0 0 0 0 0 0 0 0 0 0 0 0 0 0 0 0 0 0 0 0 0 0 0 0 
0 0 0 0 0 0 0 0 0 0 0 0 0 0 0 0 0 0 0 0 0 0 0 0 0 0 0 0 0 0 0 0 0 0 0 0 0 0 0 0 
0 0 0 0 0 0 0 0 0 0 0 0 0 0 0 0 0 0 0 0 0 0 0 0 0 0 0 0 0 0 0 0 0 0 0 0 0 0 0 0 
0 0 0 0 0 0 0 0 0 0 0 0 0 0 0 0 0 0 0 0 0 0 0 0 0 0 0 0 0 0 0 0 0 0 0 0 0 0 0 0 
0 0 0 0 0 0 0 0 0 0 0 0 0 0 0 0 0 0 0 0 0 0 0 0 0 0 0 0 0 0 0 0 0 0 0 0 0 0 0 0 
0 0 0 0 0 0 0 0 0 0 0 0 0 0 0 0 0 0 0 0 0 0 0 0 0 0 0 0 0 0 0 0 0 0 0 0 0 0 0 0 
