[TILESET]
TileSheet

[TERRAIN]
112 113 112 2 106 108 112 2 2 59 16 16 16 16 70 56 64 2 1 1 1 2 59 16 16 16 58 2 2 1 2 1 1 2 2 2 67 71 16 16 70 64 2 2 1 1 1 1 2 2 2 108 105 105 105 105 105 105 105 105 
110 115 114 115 105 107 110 2 65 68 16 16 16 16 16 69 66 2 1 106 2 65 68 16 16 16 70 56 56 64 1 1 1 2 106 2 1 59 16 16 16 70 64 65 56 56 64 1 1 65 64 108 105 105 105 105 105 105 105 105 
2 113 105 105 105 112 2 65 68 16 16 16 16 16 69 66 106 106 115 105 114 59 16 16 16 16 16 16 16 70 64 1 2 115 105 114 2 59 16 16 16 16 70 68 16 16 70 56 56 68 58 113 104 105 105 105 105 105 105 105 
106 115 105 104 112 110 2 59 16 16 16 16 69 57 66 115 105 105 105 105 107 67 57 57 71 16 16 16 16 69 66 1 2 108 105 112 65 68 16 16 69 57 57 57 71 69 71 16 16 16 58 111 109 113 105 105 105 105 105 105 
105 105 107 109 110 2 65 68 16 16 69 57 66 1 2 113 105 105 105 105 104 114 115 114 59 16 16 16 16 58 1 1 2 113 112 110 59 16 69 57 66 106 115 114 67 66 67 71 16 16 70 56 64 111 108 105 105 105 105 105 
105 105 107 2 2 65 68 16 16 69 66 2 2 1 2 111 113 104 104 112 109 113 104 112 67 57 71 16 16 70 64 2 2 111 110 65 68 69 66 1 115 105 104 112 2 2 2 67 57 71 16 16 70 64 113 104 104 105 105 105 
105 105 105 114 2 59 16 16 69 66 1 2 1 2 2 2 111 109 109 110 2 111 109 110 2 2 67 57 71 16 70 56 56 56 56 68 69 66 2 115 105 107 109 110 2 1 2 1 1 67 57 57 57 66 111 109 109 113 105 105 
105 105 104 112 2 59 16 16 58 2 2 65 56 56 56 64 1 2 2 1 2 2 1 2 2 1 1 2 67 71 16 16 16 69 57 57 66 2 2 113 104 112 2 1 2 2 1 1 2 1 2 2 1 1 2 2 1 111 113 105 
105 112 109 110 65 68 16 69 66 2 65 68 16 16 16 70 56 64 2 1 2 2 2 2 2 1 2 2 2 67 57 57 57 66 2 2 1 1 1 111 109 110 2 2 65 56 56 64 1 2 1 1 2 2 2 2 1 1 111 113 
112 110 2 65 68 16 69 66 2 2 67 71 16 16 16 16 69 66 2 65 64 1 65 64 1 2 2 2 1 1 1 2 2 2 2 2 2 2 1 2 1 1 2 65 68 16 16 70 56 64 2 1 1 2 2 2 2 1 2 2 
2 65 56 68 16 16 58 2 1 2 2 67 57 57 57 57 66 2 2 59 70 56 68 58 2 1 65 56 64 2 2 2 2 1 1 65 56 64 2 2 2 2 2 67 71 16 69 57 57 66 2 2 1 2 2 1 1 2 1 2 
56 68 16 16 16 16 58 2 2 1 2 2 1 1 1 2 1 2 65 68 16 16 16 58 2 1 59 16 70 56 56 56 64 65 56 68 69 66 2 65 56 64 1 1 67 57 66 2 2 2 2 2 2 2 2 2 2 2 2 2 
16 16 16 16 16 16 58 2 1 2 65 56 56 64 1 2 2 65 68 16 16 16 69 66 2 65 68 16 16 16 16 16 70 68 16 69 66 2 65 68 16 70 56 64 1 1 2 2 2 65 64 2 2 1 1 2 2 106 106 115 
16 16 16 16 16 69 66 2 2 65 68 16 16 70 56 56 56 68 16 69 57 57 66 2 65 68 16 16 16 16 16 16 16 69 57 66 2 1 59 16 16 69 71 70 64 1 65 56 56 68 70 64 2 1 2 2 115 105 105 105 
16 16 16 16 69 66 2 2 65 68 16 16 16 16 16 16 16 16 69 66 2 1 1 2 67 71 16 16 16 16 16 16 16 58 1 2 1 2 67 57 57 66 67 71 70 56 68 69 57 57 57 66 1 1 2 2 108 105 105 105 
16 16 16 16 58 2 1 2 67 57 71 16 16 16 69 71 16 69 66 2 1 2 2 2 65 68 16 16 69 57 71 16 69 66 2 2 2 2 2 2 2 1 1 59 16 69 57 66 106 106 115 114 2 2 2 115 105 105 105 105 
16 16 16 69 66 2 2 2 2 2 67 71 16 69 66 59 69 66 65 64 1 65 56 56 68 16 16 16 58 2 67 57 66 1 1 2 1 106 106 1 1 2 2 67 71 58 106 115 104 104 104 112 2 2 1 108 105 105 105 105 
16 16 16 58 1 1 65 56 56 64 2 67 57 66 1 59 70 56 68 70 56 68 16 16 16 16 16 16 70 64 106 115 114 2 2 2 115 105 105 114 2 2 1 2 67 66 113 112 109 109 109 110 1 1 2 113 105 105 105 105 
16 16 16 70 64 65 68 16 69 66 2 2 1 2 65 68 16 16 69 57 57 57 57 71 16 16 16 16 16 58 108 105 112 2 2 115 105 105 105 105 114 1 1 2 2 2 111 110 2 1 1 2 1 2 2 111 113 105 105 105 
16 16 16 16 70 68 16 69 66 2 1 2 2 2 67 71 16 69 66 2 1 2 1 67 71 16 16 16 16 58 108 107 110 1 2 113 105 105 105 105 105 114 2 2 1 2 2 1 2 65 56 56 56 56 64 2 111 113 104 105 
16 16 16 16 16 16 69 66 1 65 56 56 64 2 2 67 57 66 2 2 1 2 1 1 67 57 57 71 16 58 113 112 1 2 2 111 113 104 105 105 105 112 2 2 1 65 56 56 56 68 16 16 16 16 70 56 56 64 109 113 
16 16 16 16 16 16 70 64 65 68 16 16 70 64 2 1 1 2 1 2 2 2 2 2 2 2 1 67 57 66 111 110 2 1 1 2 111 109 113 104 112 110 1 2 65 68 16 16 16 16 16 16 16 16 16 16 16 70 64 111 
16 16 16 16 16 16 16 70 68 16 16 16 16 70 64 2 2 2 2 65 56 64 115 114 106 106 2 2 1 1 1 2 2 2 1 1 1 2 111 109 110 2 2 65 68 16 16 69 57 57 57 57 57 71 69 57 71 16 70 56 
16 16 16 16 16 69 57 71 16 16 16 16 16 16 58 1 2 2 65 68 16 58 113 104 105 105 114 2 2 2 2 1 2 1 2 2 1 2 2 1 2 1 2 67 71 16 69 66 1 1 2 115 114 59 70 64 67 71 16 16 
71 16 69 57 57 66 1 67 71 16 69 57 71 16 58 2 2 1 59 16 69 66 111 109 113 104 105 114 1 1 1 2 1 2 2 2 65 56 56 64 2 2 1 2 59 16 70 56 64 1 2 113 112 59 69 66 1 59 16 16 
67 57 66 1 2 2 2 2 67 57 66 1 67 57 66 2 65 56 68 16 58 1 2 2 111 109 113 112 2 2 1 1 2 65 56 56 68 16 16 70 56 64 2 2 67 71 16 16 70 56 64 111 110 67 66 2 1 59 16 16 
2 2 2 1 2 1 1 2 2 2 1 2 2 1 2 2 59 69 57 57 66 1 2 2 1 2 111 110 2 2 1 1 65 68 16 16 16 16 69 71 16 70 64 2 2 67 57 57 57 71 70 64 2 2 2 1 2 59 16 16 
2 1 1 2 2 2 2 2 1 2 1 2 1 2 2 2 67 66 115 114 2 2 2 2 1 1 1 2 2 1 2 2 67 71 16 16 69 57 66 67 71 16 70 64 2 2 1 1 1 67 71 70 56 64 2 2 2 59 16 16 
2 2 106 115 114 65 56 56 64 2 2 2 2 1 2 1 2 115 105 107 1 2 2 65 64 2 2 1 65 56 64 1 2 67 57 57 66 2 1 1 59 16 16 70 56 64 2 1 1 65 68 16 16 58 1 2 65 16 16 16 
114 115 105 105 107 67 71 16 70 56 64 1 2 2 65 56 64 108 105 107 2 2 65 68 70 64 65 56 68 16 70 64 1 1 2 2 2 2 2 2 59 16 16 16 16 58 2 2 2 59 16 16 69 66 2 2 16 16 16 16 
105 105 105 105 105 114 67 71 16 16 70 56 56 64 59 69 66 108 105 107 2 1 59 16 16 70 68 16 16 16 16 70 64 2 2 2 2 1 2 65 68 16 16 16 16 58 2 2 65 68 16 16 58 2 2 65 16 16 16 16 
105 105 105 105 104 112 65 68 16 16 16 16 16 70 68 58 115 105 104 112 1 2 67 71 16 69 71 16 16 16 16 16 70 56 64 2 1 2 2 59 16 16 16 16 69 66 2 65 68 16 16 69 66 2 65 16 16 16 16 16 
105 105 104 112 109 110 67 71 16 16 16 16 16 16 16 58 113 112 109 110 65 64 2 67 57 66 67 71 16 16 69 71 16 16 70 64 1 65 56 68 16 16 16 69 66 1 2 59 16 16 16 58 1 65 16 16 16 16 16 16 
105 112 109 110 2 2 2 59 16 16 16 16 16 69 71 70 64 110 65 56 68 58 1 2 1 1 2 67 71 69 66 67 71 16 16 70 56 68 16 16 16 16 16 58 1 2 65 68 16 16 16 70 56 68 16 16 16 16 16 16 
112 110 1 2 2 1 2 59 16 16 16 69 57 66 67 71 70 56 68 16 16 70 64 2 2 2 1 2 59 70 64 2 67 71 16 16 16 16 16 16 16 69 57 66 2 2 67 71 16 16 16 16 16 16 16 16 16 16 16 16 
2 2 2 2 1 2 65 68 16 69 57 66 2 2 2 67 71 16 16 16 16 16 70 56 56 64 2 1 59 16 58 2 2 67 71 16 16 16 16 16 69 66 1 2 2 1 1 59 16 16 16 16 16 16 16 16 16 16 16 16 
2 1 2 2 2 65 68 16 69 66 2 106 115 114 1 1 59 16 16 16 16 16 16 16 16 70 64 65 68 69 66 2 65 56 68 16 16 16 69 57 66 2 106 106 2 2 106 67 57 71 16 16 16 16 16 16 16 16 16 16 
1 1 2 65 56 68 16 69 66 2 115 105 105 107 106 106 67 57 57 57 71 16 16 16 16 16 70 68 16 70 64 65 68 16 16 16 16 69 66 106 106 115 105 105 114 115 105 114 106 67 71 16 16 16 16 16 16 16 16 16 
2 65 56 68 16 69 57 66 1 106 108 105 105 105 105 105 114 2 2 1 67 57 71 16 16 16 16 16 16 16 70 68 16 16 16 16 69 66 115 105 105 105 105 105 105 105 105 105 105 114 59 16 16 16 16 16 16 16 16 16 
2 59 16 16 69 66 1 2 115 105 105 105 105 105 105 105 107 1 2 2 1 2 67 71 16 16 16 16 16 16 16 16 16 16 16 16 58 115 105 105 105 105 105 105 105 105 105 105 105 107 67 71 16 16 16 16 16 16 16 16 

[COLLISION]
0 0 0 0 0 0 0 0 0 0 0 0 0 0 0 0 0 0 0 0 0 0 0 0 0 0 0 0 0 0 0 0 0 0 0 0 0 0 0 0 0 0 0 0 0 0 0 0 0 0 0 0 0 0 0 0 0 0 0 0 
0 0 0 0 0 0 0 0 0 0 0 0 0 0 0 0 0 0 0 0 0 0 0 0 0 0 0 0 0 0 0 0 0 0 0 0 0 0 0 0 0 0 0 0 0 0 0 0 0 0 0 0 0 0 0 0 0 0 0 0 
0 0 0 0 0 0 0 0 0 0 0 0 0 0 0 0 0 0 0 0 0 0 0 0 0 0 0 0 0 0 0 0 0 0 0 0 0 0 0 0 0 0 0 0 0 0 0 0 0 0 0 0 0 0 0 0 0 0 0 0 
0 0 0 0 0 0 0 0 0 0 0 0 6 2 2 5 0 0 0 0 0 0 0 0 0 0 0 0 0 0 0 0 0 0 0 0 0 0 0 0 0 0 0 0 0 6 7 0 0 0 0 0 0 0 0 0 0 0 0 0 
0 0 0 0 0 0 0 0 0 0 6 2 13 0 0 7 0 0 0 0 1 0 0 0 0 0 0 0 0 0 0 0 0 0 0 0 0 0 6 2 7 0 0 1 2 13 12 7 0 0 0 0 0 0 0 0 0 0 0 0 
0 0 0 0 0 0 0 0 0 6 13 0 0 0 0 0 7 1 1 6 0 7 1 6 2 2 7 0 0 0 0 0 0 0 0 0 0 6 13 0 9 0 1 6 0 0 0 12 2 7 0 0 0 6 7 1 1 0 0 0 
0 0 0 0 0 0 0 0 6 13 0 0 0 0 0 0 0 0 0 0 0 0 0 0 0 0 12 2 7 0 0 0 0 0 0 0 6 13 0 9 0 1 0 0 0 0 0 0 0 12 2 2 2 13 0 0 0 7 0 0 
0 0 0 0 0 0 0 0 5 0 0 10 4 4 4 11 0 0 0 0 0 0 0 0 0 0 0 0 12 7 0 0 0 6 2 2 13 0 0 7 1 6 0 0 0 0 0 0 0 0 0 0 0 0 0 0 0 0 7 0 
0 0 0 0 0 0 0 6 13 0 10 9 0 0 0 8 4 11 0 0 0 0 0 0 0 0 0 0 0 12 2 2 2 13 0 0 0 0 0 0 0 0 0 0 10 4 4 11 0 0 0 0 0 0 0 0 0 0 0 7 
0 0 0 0 0 0 6 13 0 0 12 7 0 0 0 0 6 13 0 10 11 0 10 11 0 0 0 0 0 0 0 0 0 0 0 0 0 0 0 0 0 0 0 10 9 0 0 8 4 11 0 0 0 0 0 0 0 0 0 0 
0 0 0 0 0 0 5 0 0 0 0 12 2 2 2 2 13 0 0 3 8 4 9 5 0 0 10 4 11 0 0 0 0 0 0 10 4 11 0 0 0 0 0 12 7 0 6 2 2 13 0 0 0 0 0 0 0 0 0 0 
0 0 0 0 0 0 5 0 0 0 0 0 0 0 0 0 0 0 10 9 0 0 0 5 0 0 3 0 8 4 4 4 11 10 4 9 6 13 0 10 4 11 0 0 12 2 13 0 0 0 0 0 0 0 0 0 0 0 0 0 
0 0 0 0 0 0 5 0 0 0 10 4 4 11 0 0 0 10 9 0 0 0 6 13 0 10 9 0 0 0 0 0 8 9 0 6 13 0 10 9 0 8 4 11 0 0 0 0 0 10 11 0 0 0 0 0 0 4 4 9 
0 0 0 0 0 6 13 0 0 10 9 0 0 8 4 4 4 9 0 6 2 2 13 0 10 9 0 0 0 0 0 0 0 6 2 13 0 0 3 0 0 6 7 8 11 0 10 4 4 9 8 11 0 0 0 0 9 0 0 0 
0 0 0 0 6 13 0 0 10 9 0 0 0 0 0 0 0 0 6 13 0 0 0 0 12 7 0 0 0 0 0 0 0 5 0 0 0 0 12 2 2 13 12 7 8 4 9 0 0 0 0 5 0 0 0 0 1 0 0 0 
0 0 0 0 5 0 0 0 12 2 7 0 0 0 6 7 0 6 13 0 0 0 0 0 10 9 0 0 0 0 0 0 6 13 0 0 0 0 0 0 0 0 0 3 0 0 0 0 0 0 0 8 0 0 0 9 0 0 0 0 
0 0 0 6 13 0 0 0 0 0 12 7 0 6 13 3 6 13 10 11 0 10 4 4 9 0 0 0 0 0 0 0 5 0 0 0 0 4 4 0 0 0 0 12 7 0 0 0 1 1 1 6 0 0 0 1 0 0 0 0 
0 0 0 5 0 0 10 4 4 11 0 12 2 13 0 3 8 4 9 8 4 9 0 0 0 0 0 0 0 0 0 0 8 0 0 0 9 0 0 8 0 0 0 0 12 2 7 6 0 0 0 0 0 0 0 7 0 0 0 0 
0 0 0 8 11 10 9 0 6 13 0 0 0 0 10 9 0 0 6 2 2 2 2 7 0 0 0 0 0 0 0 0 6 0 0 9 0 0 0 0 8 0 0 0 0 0 0 0 0 0 0 0 0 0 0 0 7 0 0 0 
0 0 0 0 8 9 0 6 13 0 0 0 0 0 12 7 0 6 13 0 0 0 0 12 7 0 0 0 0 0 0 1 0 0 0 7 0 0 0 0 0 8 0 0 0 0 0 0 0 10 4 4 4 4 11 0 0 7 0 0 
0 0 0 0 0 0 6 13 0 10 4 4 11 0 0 12 2 13 0 0 0 0 0 0 12 2 2 7 0 6 7 6 0 0 0 0 7 1 0 0 0 6 0 0 0 10 4 4 4 9 0 0 0 0 8 4 4 9 0 0 
0 0 0 0 0 0 8 11 10 9 0 0 8 11 0 0 0 0 0 0 0 0 0 0 0 0 0 12 2 13 0 0 0 0 0 0 0 0 7 1 6 0 0 0 10 9 0 0 0 0 0 0 0 0 0 0 0 0 0 0 
0 0 0 0 0 0 0 8 9 0 0 0 0 8 11 0 0 0 0 10 4 4 9 8 4 4 0 0 0 0 0 0 0 0 0 0 0 0 0 0 0 0 0 10 9 0 0 0 0 0 0 0 0 0 0 0 0 0 0 0 
0 0 0 0 0 6 2 7 0 0 0 0 0 0 5 0 0 0 10 9 0 6 7 1 0 0 8 0 0 0 0 0 0 0 0 0 0 0 0 0 0 0 0 12 7 0 0 0 0 0 0 0 0 0 0 0 0 0 0 0 
7 0 6 2 2 13 0 12 7 0 6 2 7 0 5 0 0 0 3 0 6 13 0 0 7 1 0 8 0 0 0 0 0 0 0 0 10 4 4 11 0 0 0 0 3 0 0 0 0 0 0 0 0 0 0 0 0 0 0 0 
12 2 13 0 0 0 0 0 12 2 13 0 12 2 13 0 10 4 9 0 5 0 0 0 0 0 7 6 0 0 0 0 0 10 4 4 9 0 0 8 4 11 0 0 12 7 0 0 0 0 0 0 0 0 0 0 0 0 0 0 
0 0 0 0 0 0 0 0 0 0 0 0 0 0 0 0 3 0 0 6 13 0 0 0 0 0 0 0 0 0 0 0 10 9 0 0 0 0 6 7 0 8 11 0 0 12 2 2 2 7 0 0 0 0 0 0 0 0 0 0 
0 0 0 0 0 0 0 0 0 0 0 0 0 0 0 0 12 7 0 8 0 0 0 0 0 0 0 0 0 0 0 0 12 7 0 0 6 2 13 12 7 0 8 11 0 0 0 0 0 12 7 0 0 0 0 0 0 0 0 0 
0 0 4 9 8 4 4 4 11 0 0 0 0 0 0 0 0 9 0 1 0 0 0 10 11 0 0 0 10 4 11 0 0 12 2 2 13 0 0 0 3 0 0 8 4 11 0 0 0 10 9 0 0 0 0 0 0 0 0 0 
8 9 0 0 0 0 0 0 8 4 11 0 0 0 10 4 4 1 0 1 0 0 10 9 8 11 10 4 9 0 8 11 0 0 0 0 0 0 0 0 3 0 0 0 0 5 0 0 0 3 0 0 0 0 0 0 0 0 0 0 
0 0 0 0 0 0 0 0 0 0 8 4 4 11 3 0 0 0 0 1 0 0 3 0 0 8 9 0 0 0 0 8 11 0 0 0 0 0 0 10 9 0 0 0 0 5 0 0 10 9 0 0 0 0 0 0 0 0 0 0 
0 0 0 0 0 0 0 0 0 0 0 0 0 8 9 0 0 0 1 6 0 0 12 7 0 6 7 0 0 0 0 0 8 4 11 0 0 0 0 3 0 0 0 0 6 13 0 10 9 0 0 0 0 0 0 0 0 0 0 0 
0 0 0 0 0 0 0 0 0 0 0 0 0 0 0 0 4 6 0 0 10 11 0 12 2 13 12 7 0 0 0 0 0 0 8 11 0 10 4 9 0 0 0 6 13 0 0 3 0 0 0 0 0 0 0 0 0 0 0 0 
0 0 0 0 0 0 0 0 0 0 0 0 0 0 0 0 5 0 10 4 9 5 0 0 0 0 0 12 7 0 0 0 0 0 0 8 4 9 0 0 0 0 0 5 0 0 10 9 0 0 0 0 0 0 0 0 0 0 0 0 
0 0 0 0 0 0 0 0 0 0 0 0 0 0 0 0 8 4 9 0 0 8 11 0 0 0 0 0 3 0 0 0 0 0 0 0 0 0 0 0 0 6 2 13 0 0 12 7 0 0 0 0 0 0 0 0 0 0 0 0 
0 0 0 0 0 0 0 0 0 0 0 0 0 0 0 0 0 0 0 0 0 0 8 4 4 11 0 0 3 0 0 0 0 0 0 0 0 0 0 0 6 13 0 0 0 0 0 3 0 0 0 0 0 0 0 0 0 0 0 0 
0 0 0 0 0 0 0 0 0 0 0 0 0 0 0 0 0 0 0 0 0 0 0 0 0 8 11 10 9 0 0 0 0 0 0 0 0 0 6 2 13 0 4 4 0 0 4 9 0 0 0 0 0 0 0 0 0 0 0 0 
0 0 0 0 0 0 0 0 0 0 0 0 0 0 0 0 0 0 0 0 0 0 0 0 0 0 8 9 0 0 0 0 0 0 0 0 0 0 8 4 4 9 0 0 8 9 0 0 0 0 0 0 0 0 0 0 0 0 0 0 
0 0 0 0 0 0 0 0 0 0 0 0 0 0 0 0 0 0 0 0 0 0 0 0 0 0 0 0 0 0 0 0 0 0 0 0 0 0 0 0 0 0 0 0 0 0 0 0 0 0 0 0 0 0 0 0 0 0 0 0 
0 0 0 0 0 0 0 0 0 0 0 0 0 0 0 0 0 0 0 0 0 0 0 0 0 0 0 0 0 0 0 0 0 0 0 0 0 0 0 0 0 0 0 0 0 0 0 0 0 0 0 0 0 0 0 0 0 0 0 0 
