[TILESET]
TileSheet

[TERRAIN]
14 14 14 14 14 14 14 14 14 14 14 14 14 14 14 14 14 14 14 14 
0 0 0 0 0 0 0 0 0 0 0 0 0 0 0 0 14 14 14 14 
0 0 0 0 0 0 0 0 0 0 0 0 0 0 0 0 14 14 14 14 
0 0 0 0 0 0 0 0 0 0 0 0 0 0 0 0 0 14 14 14 
0 0 0 0 0 0 0 0 0 0 0 0 0 0 0 0 0 14 14 14 
0 0 0 0 0 0 0 0 0 0 0 0 0 0 0 0 0 14 14 14 
0 0 0 0 0 0 0 0 0 0 0 0 0 0 0 0 0 0 14 14 
0 0 0 0 0 0 0 0 0 0 0 0 0 0 0 0 0 0 14 14 
0 0 0 0 0 0 0 0 0 0 0 0 0 0 0 0 0 0 14 14 
0 0 0 0 0 0 0 0 0 0 0 0 0 0 0 0 0 0 14 14 
0 0 0 0 0 0 0 0 0 0 0 0 0 0 0 0 0 0 14 14 
0 0 0 0 0 0 0 0 0 0 0 0 0 0 0 0 0 0 14 14 
0 0 0 0 0 0 0 0 0 0 0 0 0 0 0 0 0 0 0 0 
0 0 0 0 0 0 0 0 0 0 0 0 0 0 0 0 0 0 0 0 
0 0 0 0 0 0 0 0 0 0 0 0 0 0 0 0 0 0 0 0 
0 0 0 0 0 0 0 0 0 0 0 0 0 0 0 0 0 0 0 0 
0 0 0 0 0 0 0 0 0 0 0 0 0 0 0 0 0 0 0 0 
0 0 0 0 0 0 0 0 0 0 0 0 0 0 0 0 0 0 0 0 
0 0 0 0 0 0 0 0 0 0 0 0 0 0 0 0 0 0 0 0 
0 0 0 0 0 0 0 0 0 0 0 0 0 0 0 0 0 0 0 0 
[COLLISION]
0 0 0 0 0 0 0 0 0 0 0 0 0 0 0 0 0 0 0 0 
0 0 0 0 0 0 0 0 0 0 0 0 0 0 0 0 0 0 0 0 
1 1 1 1 1 1 1 1 1 1 1 1 0 0 0 1 1 1 1 0 
0 1 1 1 1 1 1 1 1 0 1 1 1 0 0 0 0 1 1 1 
0 0 0 0 0 0 1 1 0 0 1 0 1 1 0 0 0 1 1 1 
0 0 0 0 0 0 0 0 0 1 1 0 0 1 0 0 1 1 1 1 
0 0 0 0 1 0 0 0 0 1 1 1 1 1 0 0 1 1 1 0 
0 0 0 1 0 1 1 0 1 1 0 0 0 0 0 0 1 1 1 0 
0 0 0 1 0 0 0 1 1 0 0 0 0 0 0 0 0 1 1 1 
0 0 0 1 1 1 1 1 0 0 0 0 0 0 0 0 0 1 1 1 
0 0 0 0 0 0 0 0 1 1 0 0 0 0 0 0 0 0 1 1 
0 0 0 0 0 0 0 0 0 1 0 0 1 1 1 1 0 0 1 0 
0 0 0 0 0 0 0 0 0 1 1 1 1 1 1 0 0 0 1 0 
0 0 0 0 0 0 0 0 0 0 1 0 0 0 0 0 0 0 0 0 
0 0 0 0 0 0 0 0 0 0 0 0 0 0 0 0 0 0 0 0 
0 0 0 0 0 0 0 0 0 0 0 0 0 0 0 0 0 0 0 0 
0 0 0 0 0 0 0 0 0 0 0 0 0 0 0 0 0 0 0 0 
0 0 0 0 0 0 0 0 0 0 0 0 0 0 0 0 0 0 0 0 
0 0 0 0 0 0 0 0 0 0 0 0 0 0 0 0 0 0 0 0 
0 0 0 0 0 0 0 0 0 0 0 0 0 0 0 0 0 0 0 0 
