[TILESET]
bridgeDemo

[TERRAIN]
0 0 0 0 0 0 0 0 0 0 0 0 0 0 0 1 1 0 1 1 
0 0 0 0 0 0 0 0 0 0 0 0 0 0 1 1 1 1 1 1 
6 6 6 6 6 6 6 7 8 9 6 6 6 6 6 6 6 6 6 6 
16 16 16 16 16 16 16 16 14 15 16 16 16 16 16 16 16 16 16 16 
16 16 16 16 16 16 16 16 14 15 16 16 16 16 16 16 16 16 16 16 
16 16 16 16 16 16 16 16 14 15 16 16 16 16 16 16 16 16 16 16 
16 16 16 16 16 16 16 16 14 15 16 16 16 16 16 16 16 16 16 16 
16 16 16 16 16 16 16 16 14 15 16 16 16 16 16 16 16 16 16 16 
16 16 16 16 16 16 16 16 14 15 16 16 16 16 16 16 16 16 16 16 
16 16 16 16 16 16 16 16 14 15 16 16 16 16 16 16 16 16 16 16 
16 16 16 16 16 16 19 19 20 21 16 16 16 16 16 16 16 16 16 16 
16 16 16 19 19 19 19 19 20 21 16 16 16 16 16 16 16 16 16 16 
16 16 19 19 19 19 19 19 20 21 16 16 16 16 16 16 16 16 16 16 
16 19 19 19 19 19 19 19 20 21 16 16 16 16 16 16 16 16 16 16 
16 16 19 19 19 19 19 19 20 21 16 16 16 16 16 16 16 16 16 16 
24 24 24 24 24 24 24 24 26 27 24 24 24 24 24 24 24 24 24 24 
33 0 0 0 0 0 0 0 0 0 0 0 0 0 0 0 0 0 0 0 
0 0 0 0 0 0 0 0 0 0 0 0 0 0 0 0 0 0 0 0 
0 0 0 0 0 0 0 0 0 0 0 0 0 0 0 0 0 0 0 0 
0 0 0 0 0 0 0 0 0 0 0 0 0 0 0 0 0 0 0 0 

[COLLISION]
0 0 0 0 0 0 0 0 0 0 0 0 0 0 0 0 0 0 0 0 
0 0 0 0 0 0 0 0 0 0 0 0 0 0 0 0 0 0 0 0 
4 4 4 4 4 4 4 4 11 10 4 4 4 4 4 4 4 4 4 4 
0 0 0 0 0 0 0 0 5 3 0 0 0 0 0 0 0 0 0 0 
0 0 0 0 0 0 0 0 5 3 0 0 0 0 0 0 0 0 0 0 
0 0 0 0 0 0 0 0 5 3 0 0 0 0 0 0 0 0 0 0 
0 0 0 0 0 0 0 0 5 3 0 0 0 0 0 0 0 0 0 0 
0 0 0 0 0 0 0 0 5 3 0 0 0 0 0 0 0 0 0 0 
0 0 0 0 0 0 0 0 5 3 0 0 0 0 0 0 0 0 0 0 
0 0 0 0 0 0 0 0 5 3 0 0 0 0 0 0 0 0 0 0 
0 0 0 0 0 0 0 0 5 3 0 0 0 0 0 0 0 0 0 0 
0 0 0 0 0 0 0 0 5 3 0 0 0 0 0 0 0 0 0 0 
0 0 0 0 0 0 0 0 5 3 0 0 0 0 0 0 0 0 0 0 
0 0 0 0 0 0 0 0 5 3 0 0 0 0 0 0 0 0 0 0 
0 0 0 0 0 0 0 0 5 3 0 0 0 0 0 0 0 0 0 0 
2 2 2 2 2 2 2 2 13 12 2 2 2 2 2 2 2 2 2 2 
0 0 0 0 0 0 0 0 0 0 0 0 0 0 0 0 0 0 0 0 
0 0 0 0 0 0 0 0 0 0 0 0 0 0 0 0 0 0 0 0 
0 0 0 0 0 0 0 0 0 0 0 0 0 0 0 0 0 0 0 0 
0 0 0 0 0 0 0 0 0 0 0 0 0 0 0 0 0 0 0 0 
